,Release Date,Movie,Budget,Domestic Gross,Worldwide Gross,Year,Week,Dom_Profits,WW_Profits,movie_name,genre,%ROI
0,2009-12-18,Avatar,425000000,760507625,2789705275,2009,51,335507625,2364705275,Avatar,Action,0.789429705882353
1,2011-05-20,Pirates of the Caribbean: On Stranger Tides,410600000,241063875,1045663875,2011,20,-169536125,635063875,Pirates of the Caribbean: On Stranger Tides,Adventure,-0.41289850219191426
2,2015-05-01,Avengers: Age of Ultron,330600000,459005868,1403013963,2015,18,128405868,1072413963,Avengers: Age of Ultron,Action,0.3884025045372051
3,2018-04-27,Avengers: Infinity War,300000000,678815482,2048134200,2018,17,378815482,1748134200,Avengers: Infinity War,Action,1.2627182733333333
4,2017-11-17,Justice League,300000000,229024295,655945209,2017,46,-70975705,355945209,Justice League,Action,-0.23658568333333332
5,2015-11-06,Spectre,300000000,200074175,879620923,2015,45,-99925825,579620923,Spectre,Action,-0.33308608333333334
6,2012-07-20,The Dark Knight Rises,275000000,448139099,1084439099,2012,29,173139099,809439099,The Dark Knight Rises,Action,0.6295967236363637
7,2018-05-25,Solo: A Star Wars Story,275000000,213767512,393151347,2018,21,-61232488,118151347,Solo: A Star Wars Story,Adventure,-0.22266359272727274
8,2013-07-02,The Lone Ranger,275000000,89302115,260002115,2013,27,-185697885,-14997885,The Lone Ranger,Western,-0.6752650363636363
9,2012-03-09,John Carter,275000000,73058679,282778100,2012,10,-201941321,7778100,John Carter,Adventure,-0.7343320763636364
10,2010-11-24,Tangled,260000000,200821936,586477240,2010,47,-59178064,326477240,Tangled,Musical,-0.22760793846153846
11,2007-05-04,Spider-Man 3,258000000,336530303,894860230,2007,18,78530303,636860230,Spider-Man 3,Adventure,0.30438101937984496
12,2016-05-06,Captain America: Civil War,250000000,408084349,1140069413,2016,18,158084349,890069413,Captain America: Civil War,Action,0.632337396
13,2016-03-25,Batman v Superman: Dawn of Justice,250000000,330360194,867500281,2016,12,80360194,617500281,Batman v Superman: Dawn of Justice,Action,0.321440776
14,2012-12-14,The Hobbit: An Unexpected Journey,250000000,303003568,1017003568,2012,50,53003568,767003568,The Hobbit: An Unexpected Journey,Adventure,0.212014272
15,2009-07-15,Harry Potter and the Half-Blood Prince,250000000,302089278,935213767,2009,29,52089278,685213767,Harry Potter and the Half-Blood Prince,Adventure,0.208357112
16,2013-12-13,The Hobbit: The Desolation of Smaug,250000000,258366855,960366855,2013,50,8366855,710366855,The Hobbit: The Desolation of Smaug,Adventure,0.03346742
17,2014-12-17,The Hobbit: The Battle of the Five Armies,250000000,255119788,945577621,2014,51,5119788,695577621,The Hobbit: The Battle of the Five Armies,Adventure,0.020479152
18,2017-04-14,The Fate of the Furious,250000000,225764765,1234846267,2017,15,-24235235,984846267,The Fate of the Furious,Action,-0.09694094
19,2006-06-28,Superman Returns,232000000,200120000,374085065,2006,26,-31880000,142085065,Superman Returns,Adventure,-0.13741379310344828
20,2017-05-26,Pirates of the Caribbean: Dead Men Tell No Tales,230000000,172558876,788241137,2017,21,-57441124,558241137,Pirates of the Caribbean: Dead Men Tell No Tales,Adventure,-0.24974401739130433
21,2008-11-14,Quantum of Solace,230000000,169368427,591692078,2008,46,-60631573,361692078,Quantum of Solace,Action,-0.2636155347826087
22,2012-05-04,The Avengers,225000000,623279547,1517935897,2012,18,398279547,1292935897,The Avengers,Action,1.77013132
23,2013-06-14,Man of Steel,225000000,291045518,667999518,2013,24,66045518,442999518,Man of Steel,Action,0.29353563555555556
24,2008-05-16,The Chronicles of Narnia: Prince Caspian,225000000,141621490,417341288,2008,20,-83378510,192341288,The Chronicles of Narnia: Prince Caspian,Adventure,-0.37057115555555553
25,2012-07-03,The Amazing Spider-Man,220000000,262030663,757890267,2012,27,42030663,537890267,The Amazing Spider-Man,Adventure,0.19104846818181817
26,2012-05-18,Battleship,220000000,65233400,313477717,2012,20,-154766600,93477717,Battleship,Action,-0.7034845454545454
27,2017-06-21,Transformers: The Last Knight,217000000,130168683,602893340,2017,25,-86831317,385893340,Transformers: The Last Knight,Action,-0.4001443179723502
28,2015-06-12,Jurassic World,215000000,652270625,1648854864,2015,24,437270625,1433854864,Jurassic World,Action,2.0338168604651163
29,2012-05-25,Men in Black 3,215000000,179020854,654213485,2012,21,-35979146,439213485,Men in Black 3,Adventure,-0.16734486511627908
30,2009-06-24,Transformers: Revenge of the Fallen,210000000,402111870,836519699,2009,26,192111870,626519699,Transformers: Revenge of the Fallen,Action,0.9148184285714286
31,2014-06-27,Transformers: Age of Extinction,210000000,245439076,1104039076,2014,26,35439076,894039076,Transformers: Age of Extinction,Action,0.16875750476190476
32,2006-05-26,X-Men: The Last Stand,210000000,234362462,459260946,2006,21,24362462,249260946,X-Men: The Last Stand,Action,0.1160117238095238
33,2010-05-14,Robin Hood,210000000,105487148,322459006,2010,19,-104512852,112459006,Robin Hood,Action,-0.4976802476190476
34,2010-05-14,Robin Hood,210000000,105487148,322459006,2010,19,-104512852,112459006,Robin Hood,Action,-0.4976802476190476
35,2018-11-21,Robin Hood,99000000,30824628,84747441,2018,47,-68175372,-14252559,Robin Hood,Action,-0.6886401212121213
36,2018-11-21,Robin Hood,99000000,30824628,84747441,2018,47,-68175372,-14252559,Robin Hood,Action,-0.6886401212121213
37,2007-12-07,The Golden Compass,205000000,70107728,367262558,2007,49,-134892272,162262558,The Golden Compass,Adventure,-0.6580110829268293
38,2018-02-16,Black Panther,200000000,700059566,1348258224,2018,7,500059566,1148258224,Black Panther,Action,2.50029783
39,2018-06-15,Incredibles 2,200000000,608581744,1242515988,2018,24,408581744,1042515988,Incredibles 2,Adventure,2.04290872
40,2016-12-16,Rogue One: A Star Wars Story,200000000,532177324,1049102856,2016,50,332177324,849102856,Rogue One: A Star Wars Story,Adventure,1.66088662
41,2016-06-17,Finding Dory,200000000,486295561,1021215193,2016,24,286295561,821215193,Finding Dory,Adventure,1.431477805
42,2010-06-18,Toy Story 3,200000000,415004880,1068879522,2010,24,215004880,868879522,Toy Story 3,Adventure,1.0750244
43,2013-05-03,Iron Man 3,200000000,408992272,1215392272,2013,18,208992272,1015392272,Iron Man 3,Action,1.04496136
44,2010-03-05,Alice in Wonderland,200000000,334191110,1025491110,2010,9,134191110,825491110,Alice in Wonderland,Adventure,0.67095555
45,2012-11-08,Skyfall,200000000,304360277,1110526981,2012,45,104360277,910526981,Skyfall,Action,0.521801385
46,2013-06-21,Monsters University,200000000,268488329,743588329,2013,25,68488329,543588329,Monsters University,Adventure,0.342441645
47,2013-03-08,Oz the Great and Powerful,200000000,234770996,490359051,2013,10,34770996,290359051,Oz the Great and Powerful,Adventure,0.17385498
48,2014-05-23,X-Men: Days of Future Past,200000000,233921534,747862775,2014,21,33921534,547862775,X-Men: Days of Future Past,Action,0.16960767
49,2014-05-02,The Amazing Spider-Man 2,200000000,202853933,708996336,2014,18,2853933,508996336,The Amazing Spider-Man 2,Action,0.014269665
50,2011-06-24,Cars 2,200000000,191450875,560155383,2011,25,-8549125,360155383,Cars 2,Adventure,-0.042745625
51,2010-12-17,Tron: Legacy,200000000,172062763,400062763,2010,50,-27937237,200062763,Tron: Legacy,Adventure,-0.139686185
52,2009-11-13,2012,200000000,166112167,757677748,2009,46,-33887833,557677748,2012,Action,-0.169439165
53,2018-11-16,Fantastic Beasts: The Crimes of Grindelwald,200000000,159555901,652220086,2018,46,-40444099,452220086,Fantastic Beasts: The Crimes of Grindelwald,Adventure,-0.202220495
54,2009-05-21,Terminator Salvation,200000000,125322469,365491792,2009,21,-74677531,165491792,Terminator Salvation,Action,-0.373387655
55,2011-06-17,Green Lantern,200000000,116601172,219535492,2011,24,-83398828,19535492,Green Lantern,Action,-0.41699414
56,2010-05-28,Prince of Persia: Sands of Time,200000000,90759676,336359676,2010,21,-109240324,136359676,Prince of Persia: Sands of Time,Action,-0.54620162
57,2011-06-29,Transformers: Dark of the Moon,195000000,352390543,1123790543,2011,26,157390543,928790543,Transformers: Dark of the Moon,Action,0.8071309897435898
58,2017-06-09,The Mummy,195000000,80101125,409953905,2017,23,-114898875,214953905,The Mummy,Adventure,-0.589225
59,2013-03-01,Jack the Giant Slayer,195000000,65187603,197687603,2013,9,-129812397,2687603,Jack the Giant Slayer,Adventure,-0.6657046
60,2015-04-03,Furious 7,190000000,353007020,1518722794,2015,14,163007020,1328722794,Furious 7,Action,0.8579316842105263
61,2013-05-16,Star Trek Into Darkness,190000000,228778661,467381584,2013,20,38778661,277381584,Star Trek Into Darkness,Adventure,0.20409821578947368
62,2013-06-21,World War Z,190000000,202359711,531514650,2013,25,12359711,341514650,World War Z,Action,0.06505111052631579
63,2013-05-10,The Great Gatsby,190000000,144840419,351040419,2013,19,-45159581,161040419,The Great Gatsby,Drama,-0.23768200526315789
64,2013-07-12,Pacific Rim,190000000,101802906,411002906,2013,28,-88197094,221002906,Pacific Rim,Action,-0.4641952315789474
65,2015-11-25,The Good Dinosaur,187500000,123087120,333771037,2015,48,-64412880,146271037,The Good Dinosaur,Adventure,-0.34353536
66,2008-05-02,Iron Man,186000000,318604126,585171547,2008,18,132604126,399171547,Iron Man,Adventure,0.7129254086021506
67,2008-07-18,The Dark Knight,185000000,533720947,1001996207,2008,29,348720947,816996207,The Dark Knight,Action,1.884978091891892
68,2008-05-22,Indiana Jones and the Kingdom of the Crystal Skull,185000000,317101119,786635413,2008,21,132101119,601635413,Indiana Jones and the Kingdom of the Crystal Skull,Adventure,0.7140601027027027
69,2012-06-22,Brave,185000000,237282182,554606532,2012,25,52282182,369606532,Brave,Adventure,0.2826063891891892
70,2017-03-10,Kong: Skull Island,185000000,168052812,561072059,2017,10,-16947188,376072059,Kong: Skull Island,Adventure,-0.09160642162162162
71,2016-07-22,Star Trek Beyond,185000000,158848340,335802233,2016,29,-26151660,150802233,Star Trek Beyond,Adventure,-0.14136032432432433
72,2017-10-06,Blade Runner 2049,185000000,92054159,259357408,2017,40,-92945841,74357408,Blade Runner 2049,Thriller/Suspense,-0.5024099513513514
73,2017-11-03,Thor: Ragnarok,180000000,315058289,846980024,2017,44,135058289,666980024,Thor: Ragnarok,Action,0.7503238277777777
74,2014-05-30,Maleficent,180000000,241407328,758536735,2014,22,61407328,578536735,Maleficent,Adventure,0.34115182222222223
75,2016-11-18,Fantastic Beasts and Where to Find Them,180000000,234037575,802402853,2016,46,54037575,622402853,Fantastic Beasts and Where to Find Them,Adventure,0.30020875
76,2008-06-27,WALL-E,180000000,223808164,532508025,2008,26,43808164,352508025,WALL-E,Adventure,0.2433786888888889
77,2007-08-10,Rush Hour 3,180000000,140125968,256585882,2007,32,-39874032,76585882,Rush Hour 3,Action,-0.2215224
78,2016-07-01,The Legend of Tarzan,180000000,126643061,348902025,2016,26,-53356939,168902025,The Legend of Tarzan,Adventure,-0.2964274388888889
79,2011-11-23,Hugo,180000000,73864507,180047784,2011,47,-106135493,47784,Hugo,Adventure,-0.5896416277777777
80,2017-07-21,Valerian and the City of a Thousand Planets,180000000,40479370,215098356,2017,29,-139520630,35098356,Valerian and the City of a Thousand Planets,Adventure,-0.7751146111111111
81,2015-02-06,Jupiter Ascending,179000000,47482519,181982519,2015,6,-131517481,2982519,Jupiter Ascending,Action,-0.7347345307262569
82,2016-05-27,X-Men: Apocalypse,178000000,155442489,542537546,2016,21,-22557511,364537546,X-Men: Apocalypse,Action,-0.12672758988764046
83,2018-08-10,The Meg,178000000,145443742,529530715,2018,32,-32556258,351530715,The Meg,Action,-0.18290032584269664
84,2014-06-06,Edge of Tomorrow,178000000,100206256,370541256,2014,23,-77793744,192541256,Edge of Tomorrow,Action,-0.4370435056179775
85,2016-04-15,The Jungle Book,175000000,364001123,962854547,2016,15,189001123,787854547,The Jungle Book,Adventure,1.0800064171428572
86,2015-06-19,Inside Out,175000000,356461711,854235992,2015,25,181461711,679235992,Inside Out,Adventure,1.0369240628571428
87,2017-07-07,Spider-Man: Homecoming,175000000,334201140,880166350,2017,27,159201140,705166350,Spider-Man: Homecoming,Action,0.9097208
88,2016-08-05,Suicide Squad,175000000,325100054,746059887,2016,31,150100054,571059887,Suicide Squad,Action,0.8577145942857143
89,2009-05-29,Up,175000000,293004164,731463377,2009,22,118004164,556463377,Up,Adventure,0.6743095085714286
90,2017-11-22,Coco,175000000,209726015,798008101,2017,47,34726015,623008101,Coco,Musical,0.19843437142857143
91,2018-11-21,Ralph Breaks The Internet,175000000,201091711,523480372,2018,47,26091711,348480372,Ralph Breaks The Internet,Adventure,0.14909549142857143
92,2009-03-27,Monsters vs. Aliens,175000000,198351526,381687380,2009,13,23351526,206687380,Monsters vs. Aliens,Adventure,0.13343729142857144
93,2017-06-16,Cars 3,175000000,152901115,383541369,2017,24,-22098885,208541369,Cars 3,Adventure,-0.12627934285714285
94,2009-08-07,G.I. Joe: The Rise of Cobra,175000000,150201498,302469017,2009,32,-24798502,127469017,G.I. Joe: The Rise of Cobra,Action,-0.14170572571428572
95,2008-08-01,The Mummy: Tomb of the Dragon Emperor,175000000,102491776,405760225,2008,31,-72508224,230760225,The Mummy: Tomb of the Dragon Emperor,Adventure,-0.41433270857142857
96,2007-06-22,Evan Almighty,175000000,100289690,174131329,2007,25,-74710310,-868671,Evan Almighty,Comedy,-0.42691605714285713
97,2017-05-12,King Arthur: Legend of the Sword,175000000,39175066,139630336,2017,19,-135824934,-35369664,King Arthur: Legend of the Sword,Adventure,-0.77614248
98,2013-12-25,47 Ronin,175000000,38362475,151716815,2013,52,-136637525,-23283185,47 Ronin,Action,-0.7807858571428572
99,2018-06-22,Jurassic World: Fallen Kingdom,170000000,417719760,1305772799,2018,25,247719760,1135772799,Jurassic World: Fallen Kingdom,Action,1.4571750588235295
100,2014-08-01,Guardians of the Galaxy,170000000,333172112,770867516,2014,31,163172112,600867516,Guardians of the Galaxy,Action,0.9598359529411765
101,2010-05-07,Iron Man 2,170000000,312433331,621156389,2010,18,142433331,451156389,Iron Man 2,Action,0.8378431235294118
102,2014-04-04,Captain America: The Winter Soldier,170000000,259746958,714401889,2014,14,89746958,544401889,Captain America: The Winter Soldier,Action,0.5279232823529412
103,2014-07-11,Dawn of the Planet of the Apes,170000000,208545589,710644566,2014,28,38545589,540644566,Dawn of the Planet of the Apes,Adventure,0.22673875882352942
104,2012-06-01,Snow White and the Huntsman,170000000,155136755,401021746,2012,22,-14863245,231021746,Snow White and the Huntsman,Adventure,-0.08743085294117647
105,2015-05-22,Tomorrowland,170000000,93436322,206627518,2015,21,-76563678,36627518,Tomorrowland,Adventure,-0.45037457647058826
106,2016-05-27,Alice Through the Looking Glass,170000000,77042381,276928112,2016,21,-92957619,106928112,Alice Through the Looking Glass,Adventure,-0.5468095235294118
107,2010-05-21,Shrek Forever After,165000000,238736787,756244673,2010,20,73736787,591244673,Shrek Forever After,Adventure,0.44688961818181816
108,2016-11-04,Doctor Strange,165000000,232641920,676404566,2016,44,67641920,511404566,Doctor Strange,Action,0.4099510303030303
109,2014-11-07,Big Hero 6,165000000,222527828,652127828,2014,45,57527828,487127828,Big Hero 6,Adventure,0.348653503030303
110,2010-03-26,How to Train Your Dragon,165000000,217581232,494870992,2010,12,52581232,329870992,How to Train Your Dragon,Adventure,0.31867413333333333
111,2012-11-02,Wreck-It Ralph,165000000,189412677,496511521,2012,44,24412677,331511521,Wreck-It Ralph,Adventure,0.14795561818181818
112,2014-11-05,Interstellar,165000000,188017894,665666799,2014,45,23017894,500666799,Interstellar,Adventure,0.13950238787878788
113,2016-06-24,Independence Day: Resurgence,165000000,103144286,384169424,2016,25,-61855714,219169424,Independence Day: Resurgence,Action,-0.3748831151515152
114,2011-07-29,Cowboys and Aliens,163000000,100368560,176038324,2011,30,-62631440,13038324,Cowboys and Aliens,Action,-0.38424196319018405
115,2017-03-17,Beauty and the Beast,160000000,504014165,1259199706,2017,11,344014165,1099199706,Beauty and the Beast,Musical,2.15008853125
116,2018-12-21,Aquaman,160000000,335061807,1146894640,2018,51,175061807,986894640,Aquaman,Action,1.09413629375
117,2007-05-17,Shrek the Third,160000000,322719944,807330936,2007,20,162719944,647330936,Shrek the Third,Adventure,1.01699965
118,2010-07-16,Inception,160000000,292576195,835524642,2010,28,132576195,675524642,Inception,Thriller/Suspense,0.82860121875
119,2015-11-20,The Hunger Games: Mockingjay - Part 2,160000000,281723902,648986787,2015,47,121723902,488986787,The Hunger Games: Mockingjay - Part 2,Thriller/Suspense,0.7607743875
120,2013-05-24,Fast and Furious 6,160000000,238679850,789300444,2013,21,78679850,629300444,Fast and Furious 6,Action,0.4917490625
121,2014-05-16,Godzilla,160000000,200676069,529076069,2014,20,40676069,369076069,Godzilla,Action,0.25422543125
122,2011-06-03,X-Men: First Class,160000000,146408305,355408305,2011,22,-13591695,195408305,X-Men: First Class,Action,-0.08494809375
123,2008-12-25,The Curious Case of Benjamin Button,160000000,127509326,329631958,2008,52,-32490674,169631958,The Curious Case of Benjamin Button,Drama,-0.2030667125
124,2010-07-14,The Sorcerer's Apprentice,160000000,63150991,217986320,2010,28,-96849009,57986320,The Sorcerer's Apprentice,Adventure,-0.60530630625
125,2006-05-12,Poseidon,160000000,60674817,181674817,2006,19,-99325183,21674817,Poseidon,Adventure,-0.62078239375
126,2016-06-10,Warcraft,160000000,47225655,425522281,2016,23,-112774345,265522281,Warcraft,Action,-0.70483965625
127,2016-09-30,Deepwater Horizon,156000000,61433527,122603824,2016,39,-94566473,-33396176,Deepwater Horizon,Drama,-0.6061953397435897
128,2010-12-10,The Chronicles of Narnia: The Voyage of the Dawn Treader,155000000,104386950,418186950,2010,49,-50613050,263186950,The Chronicles of Narnia: The Voyage of the Dawn Treader,Adventure,-0.3265358064516129
129,2015-07-01,Terminator: Genisys,155000000,89760956,432150894,2015,27,-65239044,277150894,Terminator: Genisys,Action,-0.4208970580645161
130,2018-03-23,Pacific Rim: Uprising,155000000,59874525,290930148,2018,12,-95125475,135930148,Pacific Rim: Uprising,Action,-0.6137127419354839
131,2017-07-14,War for the Planet of the Apes,152000000,146880162,489592267,2017,28,-5119838,337592267,War for the Planet of the Apes,Action,-0.033683144736842106
132,2007-07-02,Transformers,151000000,319246193,708272592,2007,27,168246193,557272592,Transformers,Action,1.1142131986754966
133,2017-06-02,Wonder Woman,150000000,412563408,821133378,2017,22,262563408,671133378,Wonder Woman,Action,1.75042272
134,2013-11-22,Frozen,150000000,400738009,1272469910,2013,47,250738009,1122469910,Frozen,Musical,1.6715867266666666
135,2016-03-04,Zootopia,150000000,341268248,1019429616,2016,9,191268248,869429616,Zootopia,Adventure,1.2751216533333334
136,2007-07-11,Harry Potter and the Order of the Phoenix,150000000,292137260,943076457,2007,28,142137260,793076457,Harry Potter and the Order of the Phoenix,Adventure,0.9475817333333333
137,2007-12-14,I am Legend,150000000,256393010,585532684,2007,50,106393010,435532684,I am Legend,Horror,0.7092867333333334
138,2016-11-23,Moana,150000000,248757044,637517365,2016,47,98757044,487517365,Moana,Musical,0.6583802933333334
139,2008-07-01,Hancock,150000000,227946274,624234272,2008,27,77946274,474234272,Hancock,Action,0.5196418266666667
140,2007-06-29,Ratatouille,150000000,206445654,626549695,2007,26,56445654,476549695,Ratatouille,Adventure,0.37630436
141,2013-11-08,Thor: The Dark World,150000000,206362140,644602516,2013,45,56362140,494602516,Thor: The Dark World,Action,0.3757476
142,2017-07-21,Dunkirk,150000000,190068280,499837368,2017,29,40068280,349837368,Dunkirk,Action,0.26712186666666665
143,2011-05-06,Thor,150000000,181030624,449326618,2011,18,31030624,299326618,Thor,Action,0.20687082666666667
144,2008-11-07,Madagascar: Escape 2 Africa,150000000,180174880,599680774,2008,45,30174880,449680774,Madagascar: Escape 2 Africa,Adventure,0.20116586666666667
145,2009-05-01,X-Men Origins: Wolverine,150000000,179883157,374825760,2009,18,29883157,224825760,X-Men Origins: Wolverine,Action,0.19922104666666668
146,2009-05-22,Night at the Museum: Battle of the Smithsonian,150000000,177243721,402231063,2009,21,27243721,252231063,Night at the Museum: Battle of the Smithsonian,Adventure,0.18162480666666667
147,2011-05-26,Kung Fu Panda 2,150000000,165249063,664837547,2011,21,15249063,514837547,Kung Fu Panda 2,Adventure,0.10166042
148,2015-05-15,Mad Max: Fury Road,150000000,153636354,370098020,2015,20,3636354,220098020,Mad Max: Fury Road,Action,0.02424236
149,2018-03-29,Ready Player One,150000000,137690172,579290136,2018,13,-12309828,429290136,Ready Player One,Adventure,-0.08206552
150,2009-05-15,Angels & Demons,150000000,133375846,490875846,2009,20,-16624154,340875846,Angels & Demons,Thriller/Suspense,-0.11082769333333334
151,2010-07-01,The Last Airbender,150000000,131772187,319713881,2010,26,-18227813,169713881,The Last Airbender,Adventure,-0.12151875333333333
152,2007-11-02,Bee Movie,150000000,126631277,287594577,2007,44,-23368723,137594577,Bee Movie,Adventure,-0.15579148666666667
153,2009-07-24,G-Force,150000000,119436770,292817841,2009,30,-30563230,142817841,G-Force,Adventure,-0.20375486666666667
154,2008-11-21,Bolt,150000000,114053579,328015029,2008,47,-35946421,178015029,Bolt,Adventure,-0.23964280666666668
155,2012-03-30,Wrath of the Titans,150000000,83670083,305270083,2012,13,-66329917,155270083,Wrath of the Titans,Adventure,-0.44219944666666666
156,2007-11-16,Beowulf,150000000,82280579,195080579,2007,46,-67719421,45080579,Beowulf,Adventure,-0.45146280666666666
157,2012-05-11,Dark Shadows,150000000,79727149,238202668,2012,19,-70272851,88202668,Dark Shadows,Black Comedy,-0.46848567333333335
158,2013-06-28,White House Down,150000000,73103784,205440387,2013,26,-76896216,55440387,White House Down,Thriller/Suspense,-0.51264144
159,2010-02-12,The Wolfman,150000000,62189884,142634358,2010,6,-87810116,-7365642,The Wolfman,Horror,-0.5854007733333333
160,2017-02-17,The Great Wall,150000000,45157105,334486852,2017,7,-104842895,184486852,The Great Wall,Action,-0.6989526333333334
161,2015-10-09,Pan,150000000,35088320,151525973,2015,41,-114911680,1525973,Pan,Adventure,-0.7660778666666667
162,2011-03-11,Mars Needs Moms,150000000,21392758,39549758,2011,10,-128607242,-110450242,Mars Needs Moms,Adventure,-0.8573816133333333
163,2006-11-03,Flushed Away,149000000,64665672,179357126,2006,44,-84334328,30357126,Flushed Away,Adventure,-0.5660022013422819
164,2012-06-08,Madagascar 3: Europe's Most Wanted,145000000,216391482,746921271,2012,23,71391482,601921271,Madagascar 3: Europe's Most Wanted,Adventure,0.4923550482758621
165,2014-06-13,How to Train Your Dragon 2,145000000,177002924,614586270,2014,24,32002924,469586270,How to Train Your Dragon 2,Adventure,0.22070982068965517
166,2014-03-07,Mr. Peabody & Sherman,145000000,111506430,269806430,2014,10,-33493570,124806430,Mr. Peabody & Sherman,Adventure,-0.23099013793103448
167,2012-11-21,Rise of the Guardians,145000000,103412758,306900902,2012,47,-41587242,161900902,Rise of the Guardians,Adventure,-0.2868085655172414
168,2016-07-15,Ghostbusters,144000000,128350574,229008658,2016,28,-15649426,85008658,Ghostbusters,Comedy,-0.10867656944444444
169,2009-05-08,Star Trek,140000000,257730019,386839614,2009,19,117730019,246839614,Star Trek,Adventure,0.8409287071428572
170,2011-07-22,Captain America: The First Avenger,140000000,176654505,370569776,2011,29,36654505,230569776,Captain America: The First Avenger,Action,0.26181789285714285
171,2016-01-29,Kung Fu Panda 3,140000000,143528619,517599142,2016,4,3528619,377599142,Kung Fu Panda 3,Adventure,0.02520442142857143
172,2013-03-27,G.I. Joe: Retaliation,140000000,122523060,375740705,2013,13,-17476940,235740705,G.I. Joe: Retaliation,Action,-0.12483528571428572
173,2014-12-12,Exodus: Gods and Kings,140000000,65014513,268314513,2014,50,-74985487,128314513,Exodus: Gods and Kings,Drama,-0.5356106214285714
174,2016-07-01,The BFG,140000000,55483770,199646680,2016,26,-84516230,59646680,The BFG,Adventure,-0.6036873571428572
175,2016-02-26,Gods of Egypt,140000000,31153464,138836756,2016,8,-108846536,-1163244,Gods of Egypt,Adventure,-0.7774752571428571
176,2009-03-06,Watchmen,138000000,107509799,186976250,2009,10,-30490201,48976250,Watchmen,Action,-0.22094348550724638
177,2008-06-13,The Incredible Hulk,137500000,134806913,265573859,2008,24,-2693087,128073859,The Incredible Hulk,Adventure,-0.019586087272727273
178,2013-03-22,The Croods,135000000,187168425,573068425,2013,12,52168425,438068425,The Croods,Adventure,0.3864327777777778
179,2015-12-25,The Revenant,135000000,183637894,532938302,2015,52,48637894,397938302,The Revenant,Adventure,0.3602806962962963
180,2011-03-04,Rango,135000000,123477607,245724600,2011,9,-11522393,110724600,Rango,Adventure,-0.08535105925925926
181,2013-07-17,Turbo,135000000,83028130,286896578,2013,29,-51971870,151896578,Turbo,Adventure,-0.3849768148148148
182,2016-06-03,Teenage Mutant Ninja Turtles: Out of the Shadows,135000000,82051601,245328374,2016,22,-52948399,110328374,Teenage Mutant Ninja Turtles: Out of the Shadows,Adventure,-0.39221036296296297
183,2011-11-18,Happy Feet Two,135000000,64006466,157956466,2011,46,-70993534,22956466,Happy Feet Two,Adventure,-0.5258780296296296
184,2006-07-28,Miami Vice,135000000,63478838,163818556,2006,30,-71521162,28818556,Miami Vice,Action,-0.5297863851851852
185,2018-11-02,The Nutcracker and the Four Realms,132900000,54858851,170293899,2018,44,-78041149,37393899,The Nutcracker and the Four Realms,Adventure,-0.5872170729872084
186,2014-11-26,Penguins of Madagascar,132000000,83350911,366942531,2014,48,-48649089,234942531,Penguins of Madagascar,Adventure,-0.36855370454545455
187,2013-11-22,The Hunger Games: Catching Fire,130000000,424668047,864868047,2013,47,294668047,734868047,The Hunger Games: Catching Fire,Adventure,2.2666772846153846
188,2007-08-03,The Bourne Ultimatum,130000000,227471070,444043396,2007,31,97471070,314043396,The Bourne Ultimatum,Thriller/Suspense,0.7497774615384616
189,2018-07-06,Ant-Man and the Wasp,130000000,216648740,623144660,2018,27,86648740,493144660,Ant-Man and the Wasp,Action,0.6665287692307692
190,2008-06-06,Kung Fu Panda,130000000,215434591,631910531,2008,23,85434591,501910531,Kung Fu Panda,Adventure,0.6571891615384615
191,2015-07-17,Ant-Man,130000000,180202163,518858449,2015,29,50202163,388858449,Ant-Man,Action,0.3861704846153846
192,2015-03-27,Home,130000000,177397510,385997896,2015,13,47397510,255997896,Home,Documentary,0.36459623076923076
193,2015-03-27,Home,130000000,177397510,385997896,2015,13,47397510,255997896,Home,Adventure,0.36459623076923076
194,2018-12-19,Mary Poppins Returns,130000000,171958438,340246439,2018,51,41958438,210246439,Mary Poppins Returns,Musical,0.3227572153846154
195,2011-10-28,Puss in Boots,130000000,149260504,554987477,2011,43,19260504,424987477,Puss in Boots,Adventure,0.14815772307692307
196,2010-11-05,Megamind,130000000,148415853,321887208,2010,44,18415853,191887208,Megamind,Adventure,0.1416604076923077
197,2014-04-11,Rio 2,130000000,131538435,492846291,2014,15,1538435,362846291,Rio 2,Adventure,0.011834115384615384
198,2010-07-23,Salt,130000000,118311368,290650494,2010,29,-11688632,160650494,Salt,Thriller/Suspense,-0.08991255384615385
199,2014-03-28,Noah,130000000,101200044,352831065,2014,13,-28799956,222831065,Noah,Drama,-0.22153812307692308
200,2011-12-21,The Adventures of Tintin,130000000,77591831,373993951,2011,51,-52408169,243993951,The Adventures of Tintin,Adventure,-0.40313976153846154
201,2013-05-31,After Earth,130000000,60522097,251499665,2013,22,-69477903,121499665,After Earth,Action,-0.5344454076923076
202,2008-11-26,Australia,130000000,49554002,215080810,2008,48,-80445998,85080810,Australia,Drama,-0.6188153692307692
203,2013-07-19,R.I.P.D.,130000000,33618855,79076678,2013,29,-96381145,-50923322,R.I.P.D.,Action,-0.7413934230769231
204,2019-02-22,How to Train Your Dragon: The Hidden World,129000000,160799505,519246496,2019,8,31799505,390246496,How to Train Your Dragon: The Hidden World,Adventure,0.24650779069767442
205,2017-03-03,Logan,127000000,226277068,615461394,2017,9,99277068,488461394,Logan,Action,0.7817091968503938
206,2014-12-19,Night at the Museum: Secret of the Tomb,127000000,113746621,353756621,2014,51,-13253379,226756621,Night at the Museum: Secret of the Tomb,Adventure,-0.10435731496062992
207,2011-07-15,Harry Potter and the Deathly Hallows: Part II,125000000,381193157,1341693157,2011,28,256193157,1216693157,Harry Potter and the Deathly Hallows: Part II,Adventure,2.049545256
208,2014-11-21,The Hunger Games: Mockingjay - Part 1,125000000,337135885,766575131,2014,47,212135885,641575131,The Hunger Games: Mockingjay - Part 1,Thriller/Suspense,1.69708708
209,2010-11-19,Harry Potter and the Deathly Hallows: Part I,125000000,296131568,960431568,2010,46,171131568,835431568,Harry Potter and the Deathly Hallows: Part I,Adventure,1.369052544
210,2006-05-19,The Da Vinci Code,125000000,217536138,767820459,2006,20,92536138,642820459,The Da Vinci Code,Thriller/Suspense,0.740289104
211,2011-04-29,Fast Five,125000000,210031325,630163454,2011,17,85031325,505163454,Fast Five,Action,0.6802506
212,2014-08-08,Teenage Mutant Ninja Turtles,125000000,191204754,485004754,2014,32,66204754,360004754,Teenage Mutant Ninja Turtles,Adventure,0.529638032
213,2011-12-16,Sherlock Holmes: A Game of Shadows,125000000,186848418,535663443,2011,50,61848418,410663443,Sherlock Holmes: A Game of Shadows,Action,0.494787344
214,2017-03-31,The Boss Baby,125000000,175003033,510878762,2017,13,50003033,385878762,The Boss Baby,Adventure,0.400024264
215,2010-04-01,Clash of the Titans,125000000,163214888,493214888,2010,13,38214888,368214888,Clash of the Titans,Action,0.305719104
216,2016-11-04,Trolls,125000000,153707064,344150134,2016,44,28707064,219150134,Trolls,Adventure,0.229656512
217,2012-06-08,Prometheus,125000000,126477084,402448265,2012,23,1477084,277448265,Prometheus,Adventure,0.011816672
218,2012-08-10,The Bourne Legacy,125000000,113203870,280355920,2012,32,-11796130,155355920,The Bourne Legacy,Thriller/Suspense,-0.09436904
219,2018-07-13,Skyscraper,125000000,68420120,304115534,2018,28,-56579880,179115534,Skyscraper,Action,-0.45263904
220,2012-08-03,Total Recall,125000000,58877969,211856088,2012,31,-66122031,86856088,Total Recall,Action,-0.528976248
221,2017-01-13,Monster Trucks,125000000,33370166,61642798,2017,2,-91629834,-63357202,Monster Trucks,Adventure,-0.733038672
222,2016-07-29,Jason Bourne,120000000,162192920,416168316,2016,30,42192920,296168316,Jason Bourne,Action,0.35160766666666665
223,2007-06-15,Fantastic Four: Rise of the Silver Surfer,120000000,131921738,289480691,2007,24,11921738,169480691,Fantastic Four: Rise of the Silver Surfer,Action,0.09934781666666667
224,2012-11-21,Life of Pi,120000000,124987022,620912003,2012,47,4987022,500912003,Life of Pi,Drama,0.04155851666666667
225,2007-02-16,Ghost Rider,120000000,115802596,229545589,2007,7,-4197404,109545589,Ghost Rider,Action,-0.03497836666666667
226,2018-04-13,Rampage,120000000,101028233,428056280,2018,15,-18971767,308056280,Rampage,Action,-0.15809805833333335
227,2013-08-09,Elysium,120000000,93050117,286192091,2013,32,-26949883,166192091,Elysium,Action,-0.22458235833333334
228,2013-04-19,Oblivion,120000000,89107235,287916633,2013,16,-30892765,167916633,Oblivion,Thriller/Suspense,-0.25743970833333335
229,2017-03-24,Power Rangers,120000000,85364450,142531552,2017,12,-34635550,22531552,Power Rangers,Action,-0.28862958333333333
230,2014-02-12,RoboCop,120000000,58607007,242981799,2014,7,-61392993,122981799,RoboCop,Action,-0.511608275
231,2015-08-07,Fantastic Four,120000000,56117548,167849187,2015,32,-63882452,47849187,Fantastic Four,Action,-0.5323537666666667
232,2005-07-08,Fantastic Four,87500000,154696080,333132750,2005,27,67196080,245632750,Fantastic Four,Action,0.7679552
233,2008-05-09,Speed Racer,120000000,43945766,93394462,2008,19,-76054234,-26605538,Speed Racer,Action,-0.6337852833333333
234,2010-12-17,How Do You Know?,120000000,30212620,49628177,2010,50,-89787380,-70371823,How Do You Know?,Romantic Comedy,-0.7482281666666667
235,2010-06-23,Knight and Day,117000000,76423035,258751370,2010,25,-40576965,141751370,Knight and Day,Action,-0.3468116666666667
236,2018-10-05,Venom,116000000,213511408,853628605,2018,40,97511408,737628605,Venom,Action,0.8406155862068966
237,2005-09-16,Venom,25000000,881745,881745,2005,37,-24118255,-24118255,Venom,Action,-0.9647302
238,2013-07-26,The Wolverine,115000000,132556852,416456852,2013,30,17556852,301456852,The Wolverine,Action,0.15266827826086957
239,2010-12-25,Gulliver's Travels,112000000,42779261,232017848,2010,51,-69220739,120017848,Gulliver's Travels,Adventure,-0.6180423125
240,2017-12-15,Ferdinand,111000000,84410380,289838913,2017,50,-26589620,178838913,Ferdinand,Adventure,-0.23954612612612614
241,2018-05-18,Deadpool 2,110000000,324591735,786680557,2018,20,214591735,676680557,Deadpool 2,Action,1.9508339545454545
242,2013-10-04,Gravity,110000000,274092705,693698673,2013,40,164092705,583698673,Gravity,Thriller/Suspense,1.4917518636363636
243,2006-12-22,Night at the Museum,110000000,250863268,579446407,2006,51,140863268,469446407,Night at the Museum,Adventure,1.2805751636363636
244,2015-05-29,San Andreas,110000000,155190832,456258539,2015,22,45190832,346258539,San Andreas,Adventure,0.4108257454545455
245,2011-07-29,The Smurfs,110000000,142614158,563749323,2011,30,32614158,453749323,The Smurfs,Adventure,0.29649234545454545
246,2007-06-27,Live Free or Die Hard,110000000,134529403,382288147,2007,26,24529403,272288147,Live Free or Die Hard,Action,0.22299457272727272
247,2015-03-20,The Divergent Series: Insurgent,110000000,130179072,295075882,2015,12,20179072,185075882,The Divergent Series: Insurgent,Action,0.18344610909090908
248,2014-03-07,300: Rise of an Empire,110000000,106580051,330780051,2014,10,-3419949,220780051,300: Rise of an Empire,Action,-0.031090445454545455
249,2016-12-21,Passengers,110000000,100014699,302239672,2016,51,-9985301,192239672,Passengers,Thriller/Suspense,-0.09077546363636364
250,2011-01-14,The Green Hornet,110000000,98780042,229155503,2011,2,-11219958,119155503,The Green Hornet,Action,-0.10199961818181819
251,2011-10-07,Real Steel,110000000,85463309,263880341,2011,40,-24536691,153880341,Real Steel,Action,-0.22306082727272727
252,2010-06-11,The A-Team,110000000,77222099,177241171,2010,23,-32777901,67241171,The A-Team,Action,-0.29798091818181816
253,2013-07-31,The Smurfs 2,110000000,71017784,348547523,2013,31,-38982216,238547523,The Smurfs 2,Adventure,-0.3543837818181818
254,2016-03-18,The Divergent Series: Allegiant,110000000,66184051,172022517,2016,11,-43815949,62022517,The Divergent Series: Allegiant,Action,-0.3983268090909091
255,2009-06-12,The Taking of Pelham 123,110000000,65452312,152364370,2009,24,-44547688,42364370,The Taking of Pelham 123,Action,-0.4049789818181818
256,2013-11-01,Ender's Game,110000000,61737191,127983283,2013,44,-48262809,17983283,Ender's Game,Adventure,-0.4387528090909091
257,2017-03-31,Ghost in the Shell,110000000,40563557,167910690,2017,13,-69436443,57910690,Ghost in the Shell,Action,-0.6312403909090909
258,2015-10-02,The Martian,108000000,228433663,655271443,2015,40,120433663,547271443,The Martian,Thriller/Suspense,1.1151265092592593
259,2016-11-23,Allied,106000000,40098064,119266661,2016,47,-65901936,13266661,Allied,Drama,-0.6217163773584906
260,2009-11-25,The Princess and the Frog,105000000,104400899,270997378,2009,48,-599101,165997378,The Princess and the Frog,Adventure,-0.005705723809523809
261,2008-03-07,"10,000 B.C.",105000000,94784201,269065678,2008,10,-10215799,164065678,"10,000 B.C.",Adventure,-0.09729332380952381
262,2016-07-22,Ice Age: Collision Course,105000000,64063008,402156682,2016,29,-40936992,297156682,Ice Age: Collision Course,Adventure,-0.3898761142857143
263,2017-09-22,Kingsman: The Golden Circle,104000000,100234838,408803696,2017,38,-3765162,304803696,Kingsman: The Golden Circle,Action,-0.03620348076923077
264,2013-05-23,The Hangover 3,103000000,112200072,362000072,2013,21,9200072,259000072,The Hangover 3,Comedy,0.08932108737864078
265,2018-03-09,A Wrinkle in Time,103000000,100478608,133401882,2018,10,-2521392,30401882,A Wrinkle in Time,Adventure,-0.024479533980582523
266,2009-07-01,Public Enemies,102500000,97104620,212282709,2009,27,-5395380,109782709,Public Enemies,Drama,-0.052637853658536585
267,2006-11-17,Casino Royale,102000000,167365000,594420283,2006,46,65365000,492420283,Casino Royale,Action,0.6408333333333334
268,2018-12-21,Bumblebee,102000000,127195589,465195589,2018,51,25195589,363195589,Bumblebee,Adventure,0.24701557843137256
269,2012-10-26,Cloud Atlas,102000000,27108272,130673154,2012,43,-74891728,28673154,Cloud Atlas,Drama,-0.7342326274509804
270,2012-12-25,Django Unchained,100000000,162805434,449948323,2012,52,62805434,349948323,Django Unchained,Western,0.62805434
271,2010-12-22,Little Fockers,100000000,148438600,310650574,2010,51,48438600,210650574,Little Fockers,Comedy,0.484386
272,2007-11-02,American Gangster,100000000,130164645,267985456,2007,44,30164645,167985456,American Gangster,Drama,0.30164645
273,2009-09-18,Cloudy with a Chance of Meatballs,100000000,124870275,236827677,2009,38,24870275,136827677,Cloudy with a Chance of Meatballs,Adventure,0.24870275
274,2010-08-06,The Other Guys,100000000,119219978,170936470,2010,31,19219978,70936470,The Other Guys,Comedy,0.19219978
275,2013-12-25,The Wolf of Wall Street,100000000,116900694,389870414,2013,52,16900694,289870414,The Wolf of Wall Street,Black Comedy,0.16900694
276,2013-05-24,Epic,100000000,107518682,262794441,2013,21,7518682,162794441,Epic,Adventure,0.07518682
277,2012-08-17,The Expendables 2,100000000,85028192,311979256,2012,33,-14971808,211979256,The Expendables 2,Action,-0.14971808
278,2009-10-16,Where the Wild Things Are,100000000,77233467,99123656,2009,42,-22766533,-876344,Where the Wild Things Are,Adventure,-0.22766533
279,2006-12-15,Eragon,100000000,75030163,249488115,2006,50,-24969837,149488115,Eragon,Adventure,-0.24969837
280,2014-07-25,Hercules,100000000,72688614,243388614,2014,30,-27311386,143388614,Hercules,Action,-0.27311386
281,2010-12-10,The Tourist,100000000,67631157,278731369,2010,49,-32368843,178731369,The Tourist,Thriller/Suspense,-0.32368843
282,2007-06-08,Surf's Up,100000000,58867694,145395745,2007,23,-41132306,45395745,Surf's Up,Adventure,-0.41132306
283,2006-12-08,Blood Diamond,100000000,57377916,171377916,2006,49,-42622084,71377916,Blood Diamond,Action,-0.42622084
284,2010-09-24,Legend of the Guardians: The Owls of Ga'Hoole,100000000,55675313,139716717,2010,38,-44324687,39716717,Legend of the Guardians: The Owls of Ga'Hoole,Adventure,-0.44324687
285,2009-06-05,Land of the Lost,100000000,49438370,69548641,2009,23,-50561630,-30451359,Land of the Lost,Comedy,-0.5056163
286,2014-08-15,The Expendables 3,100000000,39322544,209461378,2014,33,-60677456,109461378,The Expendables 3,Action,-0.60677456
287,2010-03-12,Green Zone,100000000,35497337,97523020,2010,10,-64502663,-2476980,Green Zone,Drama,-0.64502663
288,2017-10-20,Geostorm,100000000,33700160,220796009,2017,42,-66299840,120796009,Geostorm,Action,-0.6629984
289,2015-12-25,Point Break,100000000,28782481,126704591,2015,52,-71217519,26704591,Point Break,Action,-0.71217519
290,2015-12-11,In the Heart of the Sea,100000000,25020758,89693309,2015,50,-74979242,-10306691,In the Heart of the Sea,Adventure,-0.74979242
291,2014-04-18,Transcendence,100000000,23022309,103039258,2014,16,-76977691,3039258,Transcendence,Thriller/Suspense,-0.76977691
292,2018-12-14,Mortal Engines,100000000,15951040,85287417,2018,50,-84048960,-14712583,Mortal Engines,Action,-0.8404896
293,2015-11-06,The Peanuts Movie,99000000,130178411,250091610,2015,45,31178411,151091610,The Peanuts Movie,Adventure,0.31493344444444443
294,2019-02-08,The LEGO Movie 2: The Second Part,99000000,105806508,190209817,2019,6,6806508,91209817,The LEGO Movie 2: The Second Part,Adventure,0.06875260606060606
295,2017-05-19,Alien: Covenant,97000000,74262031,238521247,2017,20,-22737969,141521247,Alien: Covenant,Horror,-0.23441205154639175
296,2015-03-13,Cinderella,95000000,201151353,534551353,2015,11,106151353,439551353,Cinderella,Drama,1.1173826631578947
297,2012-07-13,Ice Age: Continental Drift,95000000,161321843,879765137,2012,28,66321843,784765137,Ice Age: Continental Drift,Adventure,0.6981246631578948
298,2010-05-27,Sex and the City 2,95000000,95347692,294680778,2010,21,347692,199680778,Sex and the City 2,Comedy,0.003659915789473684
299,2010-02-12,Percy Jackson & the Olympians: The Lightning Thief,95000000,88768303,223050874,2010,6,-6231697,128050874,Percy Jackson & the Olympians: The Lightning Thief,Adventure,-0.06559681052631579
300,2012-08-10,The Campaign,95000000,86907746,104907746,2012,32,-8092254,9907746,The Campaign,Comedy,-0.08518162105263158
301,2010-11-12,Unstoppable,95000000,81562942,165720921,2010,45,-13437058,70720921,Unstoppable,Action,-0.14144271578947368
302,2009-12-11,The Lovely Bones,95000000,44114232,94894448,2009,50,-50885768,-105552,The Lovely Bones,Drama,-0.5356396631578947
303,2016-08-19,Ben-Hur,95000000,26410477,91669648,2016,33,-68589523,-3330352,Ben-Hur,Drama,-0.7219949789473684
304,2015-02-06,Seventh Son,95000000,17725785,108874967,2015,6,-77274215,13874967,Seventh Son,Adventure,-0.8134127894736842
305,2015-02-13,Kingsman: The Secret Service,94000000,128261724,404561724,2015,7,34261724,310561724,Kingsman: The Secret Service,Action,0.3644864255319149
306,2011-08-05,Rise of the Planet of the Apes,93000000,176760185,470986200,2011,31,83760185,377986200,Rise of the Planet of the Apes,Adventure,0.9006471505376344
307,2008-02-14,The Spiderwick Chronicles,92500000,71195053,162839667,2008,7,-21304947,70339667,The Spiderwick Chronicles,Adventure,-0.23032375135135136
308,2013-02-14,A Good Day to Die Hard,92000000,67349198,304249198,2013,7,-24650802,212249198,A Good Day to Die Hard,Action,-0.2679435
309,2013-12-25,The Secret Life of Walter Mitty,91000000,58236838,187861183,2013,52,-32763162,96861183,The Secret Life of Walter Mitty,Adventure,-0.36003474725274726
310,2017-12-20,Jumanji: Welcome to the Jungle,90000000,404508916,964496193,2017,51,314508916,874496193,Jumanji: Welcome to the Jungle,Adventure,3.494543511111111
311,2009-12-25,Sherlock Holmes,90000000,209028679,498438212,2009,52,119028679,408438212,Sherlock Holmes,Adventure,1.3225408777777778
312,2009-07-01,Ice Age: Dawn of the Dinosaurs,90000000,196573705,859701857,2009,27,106573705,769701857,Ice Age: Dawn of the Dinosaurs,Adventure,1.1841522777777778
313,2018-12-14,Spider-Man: Into The Spider-Verse 3D,90000000,190173195,375380731,2018,50,100173195,285380731,Spider-Man: Into The Spider-Verse 3D,Adventure,1.1130355
314,2011-04-15,Rio,90000000,143619809,487519809,2011,15,53619809,397519809,Rio,Adventure,0.5957756555555556
315,2006-10-06,The Departed,90000000,132384315,289660619,2006,40,42384315,199660619,The Departed,Drama,0.47093683333333336
316,2008-08-13,Tropic Thunder,90000000,110515313,191145256,2008,33,20515313,101145256,Tropic Thunder,Comedy,0.2279479222222222
317,2011-12-20,The Girl with the Dragon Tattoo,90000000,102515793,239373970,2011,51,12515793,149373970,The Girl with the Dragon Tattoo,Thriller/Suspense,0.13906436666666666
318,2008-06-06,You Don't Mess With the Zohan,90000000,100018837,202910991,2008,23,10018837,112910991,You Don't Mess With the Zohan,Comedy,0.11132041111111111
319,2016-09-23,The Magnificent Seven,90000000,93432655,162525156,2016,38,3432655,72525156,The Magnificent Seven,Western,0.03814061111111111
320,2015-12-18,Alvin and the Chipmunks: The Road Chip,90000000,85886987,249517956,2015,51,-4113013,159517956,Alvin and the Chipmunks: The Road Chip,Adventure,-0.045700144444444445
321,2008-12-25,Valkyrie,90000000,83107829,203932174,2008,52,-6892171,113932174,Valkyrie,Thriller/Suspense,-0.07657967777777777
322,2015-07-24,Pixels,90000000,78765986,244041804,2015,30,-11234014,154041804,Pixels,Adventure,-0.12482237777777777
323,2013-08-07,Percy Jackson: Sea of Monsters,90000000,68559554,200859554,2013,32,-21440446,110859554,Percy Jackson: Sea of Monsters,Adventure,-0.23822717777777777
324,2016-06-10,Now You See Me 2,90000000,65075540,328325007,2016,23,-24924460,238325007,Now You See Me 2,Thriller/Suspense,-0.27693844444444443
325,2018-03-16,Tomb Raider,90000000,58250803,273477501,2018,11,-31749197,183477501,Tomb Raider,Action,-0.35276885555555554
326,2011-08-19,Conan the Barbarian,90000000,21295021,63356133,2011,33,-68704979,-26643867,Conan the Barbarian,Action,-0.7633886555555556
327,2011-10-21,The Three Musketeers,90000000,20377913,139877913,2011,42,-69622087,49877913,The Three Musketeers,Adventure,-0.7735787444444444
328,2017-04-21,The Promise,90000000,8224288,10551417,2017,16,-81775712,-79448583,The Promise,Drama,-0.9086190222222222
329,2010-11-24,The Nutcracker in 3D,90000000,195459,20466016,2010,47,-89804541,-69533984,The Nutcracker in 3D,Musical,-0.9978282333333334
330,2018-09-14,The Predator,88000000,51024708,159487563,2018,37,-36975292,71487563,The Predator,Action,-0.42017377272727274
331,2006-11-17,Happy Feet,85000000,198000317,385000317,2006,46,113000317,300000317,Happy Feet,Adventure,1.329415494117647
332,2009-04-03,Fast & Furious,85000000,155064265,363064265,2009,14,70064265,278064265,Fast & Furious,Action,0.8242854705882353
333,2008-03-14,Horton Hears a Who,85000000,154529439,299477886,2008,11,69529439,214477886,Horton Hears a Who,Adventure,0.8179934
334,2014-03-21,Divergent,85000000,150947895,276014965,2014,12,65947895,191014965,Divergent,Adventure,0.7758575882352942
335,2012-09-28,Hotel Transylvania,85000000,148313048,378505812,2012,39,63313048,293505812,Hotel Transylvania,Adventure,0.7448593882352941
336,2007-11-21,Enchanted,85000000,127706877,340384141,2007,47,42706877,255384141,Enchanted,Romantic Comedy,0.5024338470588235
337,2012-02-10,Safe House,85000000,126181630,208542162,2012,6,41181630,123542162,Safe House,Thriller/Suspense,0.48448976470588234
338,2007-07-20,I Now Pronounce You Chuck and Larry,85000000,119725280,185708462,2007,29,34725280,100708462,I Now Pronounce You Chuck and Larry,Comedy,0.40853270588235296
339,2007-06-08,Ocean's Thirteen,85000000,117144465,311744465,2007,23,32144465,226744465,Ocean's Thirteen,Adventure,0.37817017647058826
340,2006-09-29,Open Season,85000000,85105259,191932158,2006,39,105259,106932158,Open Season,Adventure,0.0012383411764705882
341,2011-11-04,Tower Heist,85000000,78046570,150422946,2011,44,-6953430,65422946,Tower Heist,Comedy,-0.08180505882352941
342,2012-03-30,Mirror Mirror,85000000,64935167,173613482,2012,13,-20064833,88613482,Mirror Mirror,Adventure,-0.23605685882352942
343,2006-12-08,The Holiday,85000000,63280000,205190324,2006,49,-21720000,120190324,The Holiday,Romantic Comedy,-0.2555294117647059
344,2006-06-16,The Fast and the Furious: Tokyo Drift,85000000,62615510,157794205,2006,24,-22384490,72794205,The Fast and the Furious: Tokyo Drift,Action,-0.26334694117647056
345,2011-11-23,Arthur Christmas,85000000,46462469,149717124,2011,47,-38537531,64717124,Arthur Christmas,Adventure,-0.45338271764705884
346,2017-01-20,xXx: Return of Xander Cage,85000000,44898413,345033359,2017,3,-40101587,260033359,xXx: Return of Xander Cage,Action,-0.4717833764705882
347,2010-07-30,Cats & Dogs: The Revenge of Kitty Galore,85000000,43585753,113026383,2010,30,-41414247,28026383,Cats & Dogs: The Revenge of Kitty Galore,Adventure,-0.48722643529411763
348,2007-03-02,Zodiac,85000000,33080084,83080084,2007,9,-51919916,-1919916,Zodiac,Thriller/Suspense,-0.6108225411764706
349,2010-08-13,Scott Pilgrim vs. The World,85000000,31611316,48056764,2010,32,-53388684,-36943236,Scott Pilgrim vs. The World,Comedy,-0.6281021647058823
350,2017-12-20,The Greatest Showman,84000000,174340174,386665550,2017,51,90340174,302665550,The Greatest Showman,Musical,1.0754782619047618
351,2013-07-19,RED 2,84000000,53262560,141507355,2013,29,-30737440,57507355,RED 2,Action,-0.3659219047619048
352,2006-06-23,Click,82500000,137355633,237685089,2006,25,54855633,155185089,Click,Comedy,0.6649167636363637
353,2006-12-15,Charlotte's Web,82500000,82985708,143985708,2006,50,485708,61485708,Charlotte's Web,Drama,0.005887369696969697
354,2008-02-14,Jumper,82500000,80172128,222640812,2008,7,-2327872,140140812,Jumper,Adventure,-0.0282166303030303
355,2008-07-11,Hellboy II: The Golden Army,82500000,75986503,160388063,2008,28,-6513497,77888063,Hellboy II: The Golden Army,Action,-0.07895147878787878
356,2010-08-13,The Expendables,82000000,103068524,268268174,2010,32,21068524,186268174,The Expendables,Action,0.2569332195121951
357,2012-03-23,The Hunger Games,80000000,408010692,677923379,2012,12,328010692,597923379,The Hunger Games,Thriller/Suspense,4.10013365
358,2011-05-26,The Hangover Part II,80000000,254464305,586464305,2011,21,174464305,506464305,The Hangover Part II,Comedy,2.1808038125
359,2017-02-10,The Lego Batman Movie,80000000,175750384,310660018,2017,6,95750384,230660018,The Lego Batman Movie,Adventure,1.1968798
360,2015-09-25,Hotel Transylvania 2,80000000,169700110,469500298,2015,39,89700110,389500298,Hotel Transylvania 2,Adventure,1.121251375
361,2013-07-12,Grown Ups 2,80000000,133668525,247023808,2013,28,53668525,167023808,Grown Ups 2,Comedy,0.6708565625
362,2011-12-16,Alvin and the Chipmunks: Chipwrecked,80000000,133107389,349088523,2011,50,53107389,269088523,Alvin and the Chipmunks: Chipwrecked,Adventure,0.6638423625
363,2008-06-20,Get Smart,80000000,130319208,226739416,2008,25,50319208,146739416,Get Smart,Comedy,0.6289901
364,2010-02-19,Shutter Island,80000000,128012934,299461782,2010,7,48012934,219461782,Shutter Island,Thriller/Suspense,0.600161675
365,2008-11-26,Four Christmases,80000000,120146040,168311558,2008,48,40146040,88311558,Four Christmases,Comedy,0.5018255
366,2008-12-25,Bedtime Stories,80000000,110101975,221468935,2008,52,30101975,141468935,Bedtime Stories,Adventure,0.3762746875
367,2011-02-11,Just Go With It,80000000,103028109,214974953,2011,6,23028109,134974953,Just Go With It,Romantic Comedy,0.2878513625
368,2008-09-26,Eagle Eye,80000000,101440743,180585259,2008,39,21440743,100585259,Eagle Eye,Thriller/Suspense,0.2680092875
369,2010-12-17,Yogi Bear,80000000,100246011,204774690,2010,50,20246011,124774690,Yogi Bear,Adventure,0.2530751375
370,2010-01-15,The Book of Eli,80000000,94835059,158750817,2010,2,14835059,78750817,The Book of Eli,Action,0.1854382375
371,2014-10-17,Fury,80000000,85817906,210315681,2014,42,5817906,130315681,Fury,Drama,0.072723825
372,2018-09-28,Smallfoot,80000000,83240103,213686569,2018,39,3240103,133686569,Smallfoot,Adventure,0.0405012875
373,2006-02-10,The Pink Panther,80000000,82226474,158926474,2006,6,2226474,78926474,The Pink Panther,Adventure,0.027830925
374,2011-07-08,Zookeeper,80000000,80360866,170805525,2011,27,360866,90805525,Zookeeper,Romantic Comedy,0.004510825
375,2008-12-12,The Day the Earth Stood Still,80000000,79366978,237370350,2008,50,-633022,157370350,The Day the Earth Stood Still,Adventure,-0.007912775
376,2009-09-25,Surrogates,80000000,38577772,119668350,2009,39,-41422228,39668350,Surrogates,Action,-0.51777785
377,2006-04-14,The Wild,80000000,37384046,99010667,2006,15,-42615954,19010667,The Wild,Adventure,-0.532699425
378,2013-12-20,Walking with Dinosaurs,80000000,36076121,123368842,2013,51,-43923879,43368842,Walking with Dinosaurs,Adventure,-0.5490484875
379,2015-10-23,The Last Witch Hunter,80000000,27367660,130818912,2015,43,-52632340,50818912,The Last Witch Hunter,Action,-0.65790425
380,2014-02-21,Pompeii,80000000,23169033,108469033,2014,8,-56830967,28469033,Pompeii,Drama,-0.7103870875
381,2009-12-18,Nine,80000000,19676965,53508858,2009,51,-60323035,-26491142,Nine,Musical,-0.7540379375
382,2010-04-22,Oceans,80000000,19422319,86787530,2010,16,-60577681,6787530,Oceans,Documentary,-0.7572210125
383,2007-01-12,Arthur et les Minimoys,80000000,15132763,113325743,2007,2,-64867237,33325743,Arthur et les Minimoys,Adventure,-0.8108404625
384,2007-08-17,The Invasion,80000000,15074191,40147042,2007,33,-64925809,-39852958,The Invasion,Thriller/Suspense,-0.8115726125
385,2012-02-10,Journey 2: The Mysterious Island,79000000,103860290,318146162,2012,6,24860290,239146162,Journey 2: The Mysterious Island,Adventure,0.3146872151898734
386,2011-11-11,Jack and Jill,79000000,74158157,150519217,2011,45,-4841843,71519217,Jack and Jill,Comedy,-0.06128915189873418
387,2013-09-27,Cloudy with a Chance of Meatballs 2,78000000,119793567,274392649,2013,39,41793567,196392649,Cloudy with a Chance of Meatballs 2,Adventure,0.5358149615384615
388,2016-02-12,The Little Prince,77500000,1311213,102028919,2016,6,-76188787,24528919,The Little Prince,Adventure,-0.9830811225806452
389,2019-01-22,Renegades,77500000,0,1521672,2019,4,-77500000,-75978328,Renegades,Action,-1.0
390,2018-07-20,The Equalizer 2,77000000,102084362,190453132,2018,29,25084362,113453132,The Equalizer 2,Action,0.32577093506493504
391,2013-07-03,Despicable Me 2,76000000,368065385,975216835,2013,27,292065385,899216835,Despicable Me 2,Adventure,3.842965592105263
392,2006-12-25,Children of Men,76000000,35552383,69845011,2006,52,-40447617,-6154989,Children of Men,Thriller/Suspense,-0.5322054868421052
393,2016-07-08,The Secret Life of Pets,75000000,368384330,886606412,2016,27,293384330,811606412,The Secret Life of Pets,Adventure,3.911791066666667
394,2016-12-21,Sing,75000000,270329045,634454789,2016,51,195329045,559454789,Sing,Adventure,2.6043872666666665
395,2017-06-30,Despicable Me 3,75000000,264624300,1034727750,2017,26,189624300,959727750,Despicable Me 3,Adventure,2.528324
396,2006-03-31,Ice Age: The Meltdown,75000000,195330621,651899282,2006,13,120330621,576899282,Ice Age: The Meltdown,Adventure,1.60440828
397,2010-06-25,Grown Ups,75000000,162001186,272223430,2010,25,87001186,197223430,Grown Ups,Comedy,1.1600158133333334
398,2008-06-27,Wanted,75000000,134508551,342416460,2008,26,59508551,267416460,Wanted,Action,0.7934473466666667
399,2007-07-20,Hairspray,75000000,118871849,203035572,2007,29,43871849,128035572,Hairspray,Musical,0.5849579866666667
400,2013-05-31,Now You See Me,75000000,117723989,342769200,2013,22,42723989,267769200,Now You See Me,Thriller/Suspense,0.5696531866666666
401,2006-12-15,Dreamgirls,75000000,103365956,155708695,2006,50,28365956,80708695,Dreamgirls,Musical,0.37821274666666665
402,2018-08-03,Christopher Robin,75000000,99215042,197504758,2018,31,24215042,122504758,Christopher Robin,Adventure,0.3228672266666667
403,2011-11-11,Immortals,75000000,83504017,211562435,2011,45,8504017,136562435,Immortals,Action,0.11338689333333334
404,2006-07-21,Monster House,75000000,73661010,141267370,2006,29,-1338990,66267370,Monster House,Adventure,-0.0178532
405,2007-12-21,Charlie Wilson's War,75000000,66661095,119512771,2007,51,-8338905,44512771,Charlie Wilson's War,Drama,-0.1111854
406,2010-06-04,Killers,75000000,47059963,95572749,2010,22,-27940037,20572749,Killers,Action,-0.3725338266666667
407,2015-08-14,The Man From U.N.C.L.E.,75000000,45445109,104949584,2015,33,-29554891,29949584,The Man From U.N.C.L.E.,Action,-0.39406521333333333
408,2006-07-21,Lady in the Water,75000000,42285169,72785169,2006,29,-32714831,-2214831,Lady in the Water,Drama,-0.43619774666666666
409,2011-03-25,Sucker Punch,75000000,36392502,89758389,2011,12,-38607498,14758389,Sucker Punch,Action,-0.51476664
410,2016-10-28,Inferno,75000000,34343574,219519367,2016,43,-40656426,144519367,Inferno,Thriller/Suspense,-0.54208568
411,2015-07-10,Minions,74000000,336045770,1160336173,2015,28,262045770,1086336173,Minions,Adventure,3.541159054054054
412,2015-02-06,The SpongeBob Movie: Sponge Out of Water,74000000,162994032,311013181,2015,6,88994032,237013181,The SpongeBob Movie: Sponge Out of Water,Adventure,1.202622054054054
413,2006-08-04,Talladega Nights: The Ballad of Ricky Bobby,73000000,148213377,162870525,2006,31,75213377,89870525,Talladega Nights: The Ballad of Ricky Bobby,Comedy,1.0303202328767123
414,2016-05-20,The Angry Birds Movie,73000000,107509366,352327887,2016,20,34509366,279327887,The Angry Birds Movie,Adventure,0.4727310410958904
415,2007-07-27,The Simpsons Movie,72500000,183135014,527071022,2007,30,110635014,454571022,The Simpsons Movie,Adventure,1.5260001931034484
416,2008-02-08,Fool's Gold,72500000,70231041,109362966,2008,6,-2268959,36862966,Fool's Gold,Adventure,-0.03129598620689655
417,2009-07-31,Funny People,72500000,51855045,71880305,2009,31,-20644955,-619695,Funny People,Comedy,-0.284758
418,2007-09-28,The Kingdom,72500000,47467250,86802457,2007,39,-25032750,14302457,The Kingdom,Action,-0.34527931034482756
419,2009-12-23,Alvin and the Chipmunks: The Squeakquel,70000000,219614612,443483213,2009,52,149614612,373483213,Alvin and the Chipmunks: The Squeakquel,Adventure,2.1373516
420,2009-08-21,Inglourious Basterds,70000000,120774594,316915264,2009,34,50774594,246915264,Inglourious Basterds,Action,0.7253513428571429
421,2013-03-22,Olympus Has Fallen,70000000,98927592,172878928,2013,12,28927592,102878928,Olympus Has Fallen,Thriller/Suspense,0.41325131428571427
422,2011-03-11,Battle: Los Angeles,70000000,83552429,213463976,2011,10,13552429,143463976,Battle: Los Angeles,Action,0.19360612857142856
423,2011-12-25,War Horse,70000000,79883359,156815529,2011,51,9883359,86815529,War Horse,Drama,0.14119084285714287
424,2014-02-07,The Monuments Men,70000000,78031620,158702748,2014,6,8031620,88702748,The Monuments Men,Drama,0.11473742857142857
425,2016-09-23,Storks,70000000,72679278,183353431,2016,38,2679278,113353431,Storks,Adventure,0.0382754
426,2012-01-20,Underworld: Awakening,70000000,62321039,160379930,2012,3,-7678961,90379930,Underworld: Awakening,Action,-0.10969944285714285
427,2017-09-22,The Lego Ninjago Movie,70000000,59281555,122737201,2017,38,-10718445,52737201,The Lego Ninjago Movie,Adventure,-0.15312064285714286
428,2014-10-10,Dracula Untold,70000000,55991880,220241723,2014,41,-14008120,150241723,Dracula Untold,Action,-0.200116
429,2006-09-29,The Guardian,70000000,55011732,94973540,2006,39,-14988268,24973540,The Guardian,Action,-0.21411811428571428
430,2010-09-24,Wall Street 2: Money Never Sleeps,70000000,52474616,137431619,2010,38,-17525384,67431619,Wall Street 2: Money Never Sleeps,Drama,-0.25036262857142855
431,2011-01-14,The Dilemma,70000000,48475290,70546865,2011,2,-21524710,546865,The Dilemma,Comedy,-0.30749585714285715
432,2007-08-10,Stardust,70000000,38634938,137022245,2007,32,-31365062,67022245,Stardust,Adventure,-0.4480723142857143
433,2012-06-15,Rock of Ages,70000000,38518613,61031932,2012,24,-31481387,-8968068,Rock of Ages,Musical,-0.4497341
434,2007-09-14,The Brave One,70000000,36793804,69792704,2007,37,-33206196,-207296,The Brave One,Drama,-0.4743742285714286
435,2016-01-29,The Finest Hours,70000000,27569558,49252761,2016,4,-42430442,-20747239,The Finest Hours,Thriller/Suspense,-0.6061491714285714
436,2013-10-18,Escape Plan,70000000,25135965,103735965,2013,42,-44864035,33735965,Escape Plan,Thriller/Suspense,-0.6409147857142857
437,2011-09-23,Killer Elite,70000000,25124986,65409046,2011,38,-44875014,-4590954,Killer Elite,Action,-0.6410716285714285
438,2014-01-10,The Legend of Hercules,70000000,18848538,58953319,2014,2,-51151462,-11046681,The Legend of Hercules,Adventure,-0.7307351714285715
439,2007-04-27,Next,70000000,18211013,73591500,2007,17,-51788987,3591500,Next,Action,-0.7398426714285714
440,2015-01-16,Blackhat,70000000,8005980,19665004,2015,3,-61994020,-50334996,Blackhat,Thriller/Suspense,-0.8856288571428571
441,2006-03-31,Basic Instinct 2,70000000,5946136,35417162,2006,13,-64053864,-34582838,Basic Instinct 2,Thriller/Suspense,-0.9150552
442,2010-05-28,Agora,70000000,619423,38992292,2010,21,-69380577,-31007708,Agora,Drama,-0.9911511
443,2010-07-09,Despicable Me,69000000,251513985,543464573,2010,27,182513985,474464573,Despicable Me,Adventure,2.6451302173913045
444,2010-07-30,Dinner for Schmucks,69000000,73026337,86796502,2010,30,4026337,17796502,Dinner for Schmucks,Comedy,0.05835271014492754
445,2018-03-02,Red Sparrow,69000000,46874505,145951861,2018,9,-22125495,76951861,Red Sparrow,Thriller/Suspense,-0.32065934782608696
446,2010-06-30,The Twilight Saga: Eclipse,68000000,300531751,706102828,2010,26,232531751,638102828,The Twilight Saga: Eclipse,Drama,3.419584573529412
447,2015-06-26,Ted 2,68000000,81476385,217214143,2015,26,13476385,149214143,Ted 2,Comedy,0.1981821323529412
448,2011-02-25,Hall Pass,68000000,45060734,87173475,2011,8,-22939266,19173475,Hall Pass,Comedy,-0.33734214705882354
449,2017-12-22,Downsizing,68000000,24449754,54462971,2017,51,-43550246,-13537029,Downsizing,Comedy,-0.6404447941176471
450,2012-03-02,Doctor Seuss' The Lorax,67500000,214030500,350976753,2012,9,146530500,283476753,Doctor Seuss' The Lorax,Adventure,2.170822222222222
451,2008-10-10,Body of Lies,67500000,39394666,118556530,2008,41,-28105334,51056530,Body of Lies,Thriller/Suspense,-0.4163753185185185
452,2012-06-22,Abraham Lincoln: Vampire Hunter,67500000,37519139,137489730,2012,25,-29980861,69989730,Abraham Lincoln: Vampire Hunter,Horror,-0.4441609037037037
453,2007-08-17,The Last Legion,67000000,5932060,25357771,2007,33,-61067940,-41642229,The Last Legion,Action,-0.9114617910447761
454,2014-03-14,Need for Speed,66000000,43568507,194169619,2014,11,-22431493,128169619,Need for Speed,Action,-0.33987110606060605
455,2012-11-09,Lincoln,65000000,182207973,273346281,2012,45,117207973,208346281,Lincoln,Drama,1.8031995846153845
456,2018-07-13,Hotel Transylvania 3: Summer Vacation,65000000,167500092,527067879,2018,28,102500092,462067879,Hotel Transylvania 3: Summer Vacation,Adventure,1.5769244923076924
457,2012-12-25,Les Miserables,65000000,148809770,442169052,2012,52,83809770,377169052,Les Miserables,Musical,1.289381076923077
458,2014-12-25,Unbroken,65000000,115637895,163527824,2014,52,50637895,98527824,Unbroken,Drama,0.7790445384615384
459,2015-06-05,Spy!,65000000,110825712,232585748,2015,23,45825712,167585748,Spy!,Comedy,0.7050109538461539
460,2010-11-05,Due Date,65000000,100539043,211739043,2010,44,35539043,146739043,Due Date,Comedy,0.5467545076923077
461,2008-07-25,Step Brothers,65000000,100468793,128468793,2008,30,35468793,63468793,Step Brothers,Comedy,0.5456737384615384
462,2014-12-19,Annie,65000000,85911262,139829625,2014,51,20911262,74829625,Annie,Musical,0.3217117230769231
463,2006-08-09,World Trade Center,65000000,70278893,163295654,2006,32,5278893,98295654,World Trade Center,Drama,0.08121373846153847
464,2012-05-16,The Dictator,65000000,59650222,180148897,2012,20,-5349778,115148897,The Dictator,Comedy,-0.08230427692307693
465,2012-02-17,This Means War,65000000,54760791,156974557,2012,7,-10239209,91974557,This Means War,Romantic Comedy,-0.1575262923076923
466,2015-02-27,Focus,65000000,53862963,168065700,2015,9,-11137037,103065700,Focus,Romantic Comedy,-0.17133903076923077
467,2012-11-21,Red Dawn,65000000,44806783,48164150,2012,47,-20193217,-16835850,Red Dawn,Action,-0.3106648769230769
468,2006-12-22,We Are Marshall,65000000,43545364,43545364,2006,51,-21454636,-21454636,We Are Marshall,Drama,-0.33007132307692305
469,2015-09-18,Everest,65000000,43482270,221297061,2015,38,-21517730,156297061,Everest,Thriller/Suspense,-0.331042
470,2012-09-14,Resident Evil: Retribution,65000000,42345531,240647629,2012,37,-22654469,175647629,Resident Evil: Retribution,Action,-0.34853029230769234
471,2008-08-22,Death Race,65000000,36316032,72516819,2008,34,-28683968,7516819,Death Race,Action,-0.44129181538461537
472,2009-10-23,Astro Boy,65000000,19551067,41636243,2009,43,-45448933,-23363757,Astro Boy,Adventure,-0.6992143538461538
473,2014-01-24,"I, Frankenstein",65000000,19075290,74575290,2014,4,-45924710,9575290,"I, Frankenstein",Action,-0.706534
474,2014-08-22,Sin City: A Dame to Kill For,65000000,13757804,40650842,2014,34,-51242196,-24349158,Sin City: A Dame to Kill For,Action,-0.7883414769230769
475,2016-12-25,Live by Night,65000000,10378555,21774432,2016,51,-54621445,-43225568,Live by Night,Drama,-0.8403299230769231
476,2015-09-04,Tian jiang xiong shi,65000000,74070,122519874,2015,36,-64925930,57519874,Tian jiang xiong shi,Action,-0.9988604615384615
477,2006-07-14,Little Man,64000000,58636047,101636047,2006,28,-5363953,37636047,Little Man,Comedy,-0.083811765625
478,2006-12-27,Perfume: The Story of a Murderer,63700000,2223293,133603463,2006,52,-61476707,69903463,Perfume: The Story of a Murderer,Drama,-0.9650974411302983
479,2011-04-01,Hop,63000000,108085305,188657593,2011,13,45085305,125657593,Hop,Adventure,0.7156397619047619
480,2017-09-15,American Assassin,63000000,36249674,68310140,2017,37,-26750326,5310140,American Assassin,Thriller/Suspense,-0.4246083492063492
481,2015-12-25,The Hateful Eight,62000000,54117416,147864886,2015,52,-7882584,85864886,The Hateful Eight,Western,-0.1271384516129032
482,2008-06-20,The Love Guru,62000000,32235793,40159017,2008,25,-29764207,-21840983,The Love Guru,Comedy,-0.4800678548387097
483,2014-10-03,Gone Girl,61000000,167767189,368567189,2014,40,106767189,307567189,Gone Girl,Thriller/Suspense,1.7502817868852458
484,2007-03-30,Blades of Glory,61000000,118594548,145594548,2007,13,57594548,84594548,Blades of Glory,Comedy,0.9441729180327869
485,2015-09-18,Maze Runner: The Scorch Trials,61000000,81697192,310566162,2015,38,20697192,249566162,Maze Runner: The Scorch Trials,Thriller/Suspense,0.3392982295081967
486,2013-08-02,2 Guns,61000000,75612460,132493015,2013,31,14612460,71493015,2 Guns,Action,0.23954852459016393
487,2018-01-26,Maze Runner: The Death Cure,61000000,58032443,265878536,2018,4,-2967557,204878536,Maze Runner: The Death Cure,Thriller/Suspense,-0.048648475409836064
488,2016-02-19,Mei Ren Yu,60720000,3229457,554516671,2016,7,-57490543,493796671,Mei Ren Yu,Romantic Comedy,-0.9468139492753623
489,2014-02-07,The Lego Movie,60000000,257784718,457729388,2014,6,197784718,397729388,The Lego Movie,Adventure,3.2964119666666667
490,2007-03-09,300,60000000,210614939,454161935,2007,10,150614939,394161935,300,Action,2.5102489833333332
491,2007-03-02,Wild Hogs,60000000,168213584,253555383,2007,9,108213584,193555383,Wild Hogs,Comedy,1.8035597333333333
492,2008-12-25,Marley & Me,60000000,143153751,247812011,2008,52,83153751,187812011,Marley & Me,Comedy,1.38589585
493,2016-09-09,Sully,60000000,125070033,238524556,2016,36,65070033,178524556,Sully,Drama,1.08450055
494,2009-10-09,Couples Retreat,60000000,109205660,172450423,2009,41,49205660,112450423,Couples Retreat,Comedy,0.8200943333333334
495,2010-10-15,Red,60000000,90380162,196439693,2010,41,30380162,136439693,Red,Action,0.5063360333333333
496,2010-08-13,Eat Pray Love,60000000,80574010,206598789,2010,32,20574010,146598789,Eat Pray Love,Drama,0.3429001666666667
497,2012-12-21,Jack Reacher,60000000,80070736,217370736,2012,51,20070736,157370736,Jack Reacher,Drama,0.33451226666666667
498,2011-09-09,Contagion,60000000,75658097,137551594,2011,36,15658097,77551594,Contagion,Thriller/Suspense,0.26096828333333333
499,2009-02-06,Coraline,60000000,75286229,126037057,2009,6,15286229,66037057,Coraline,Adventure,0.25477048333333335
500,2009-10-28,Michael Jackson's This Is It,60000000,72091016,252091016,2009,44,12091016,192091016,Michael Jackson's This Is It,Documentary,0.20151693333333334
501,2008-06-13,The Happening,60000000,64506874,162778384,2008,24,4506874,102778384,The Happening,Thriller/Suspense,0.07511456666666666
502,2016-03-04,London Has Fallen,60000000,62524260,195194085,2016,9,2524260,135194085,London Has Fallen,Action,0.042071
503,2006-03-10,The Shaggy Dog,60000000,61123569,87123569,2006,10,1123569,27123569,The Shaggy Dog,Comedy,0.01872615
504,2016-10-21,Jack Reacher: Never Go Back,60000000,58697076,159946489,2016,42,-1302924,99946489,Jack Reacher: Never Go Back,Action,-0.0217154
505,2017-05-25,Baywatch,60000000,58060186,175863783,2017,21,-1939814,115863783,Baywatch,Comedy,-0.03233023333333333
506,2015-12-25,Joy,60000000,56451232,101134059,2015,52,-3548768,41134059,Joy,Drama,-0.05914613333333334
507,2012-08-17,ParaNorman,60000000,56003051,108119662,2012,33,-3996949,48119662,ParaNorman,Adventure,-0.06661581666666666
508,2008-12-19,The Tale of Despereaux,60000000,50877145,90482317,2008,51,-9122855,30482317,The Tale of Despereaux,Adventure,-0.15204758333333335
509,2014-09-26,The Boxtrolls,60000000,50837305,111946251,2014,39,-9162695,51946251,The Boxtrolls,Adventure,-0.15271158333333335
510,2017-08-04,The Dark Tower,60000000,50701325,113461527,2017,31,-9298675,53461527,The Dark Tower,Western,-0.15497791666666666
511,2014-01-17,Jack Ryan: Shadow Recruit,60000000,50577412,131377412,2014,3,-9422588,71377412,Jack Ryan: Shadow Recruit,Action,-0.15704313333333333
512,2018-12-25,Vice,60000000,47836282,70883171,2018,52,-12163718,10883171,Vice,Black Comedy,-0.20272863333333332
513,2007-03-23,Shooter,60000000,47003582,95538560,2007,12,-12996418,35538560,Shooter,Thriller/Suspense,-0.21660696666666668
514,2013-01-11,Gangster Squad,60000000,46000903,104100903,2013,2,-13999097,44100903,Gangster Squad,Drama,-0.23331828333333332
515,2017-04-07,Smurfs: The Lost Village,60000000,45020282,197578586,2017,14,-14979718,137578586,Smurfs: The Lost Village,Adventure,-0.24966196666666668
516,2018-10-12,First Man,60000000,44936545,105212037,2018,41,-15063455,45212037,First Man,Drama,-0.25105758333333333
517,2009-06-19,Year One,60000000,43337279,57604723,2009,25,-16662721,-2395277,Year One,Comedy,-0.2777120166666667
518,2010-01-29,Edge of Darkness,60000000,43313890,82812456,2010,4,-16686110,22812456,Edge of Darkness,Drama,-0.2781018333333333
519,2009-11-20,Planet 51,60000000,42194060,108996113,2009,47,-17805940,48996113,Planet 51,Adventure,-0.29676566666666665
520,2009-03-20,Duplicity,60000000,40572825,81079566,2009,12,-19427175,21079566,Duplicity,Thriller/Suspense,-0.32378625
521,2008-09-12,Righteous Kill,60000000,40081410,78481410,2008,37,-19918590,18481410,Righteous Kill,Thriller/Suspense,-0.3319765
522,2009-12-11,Invictus,60000000,37491364,124514011,2009,50,-22508636,64514011,Invictus,Drama,-0.37514393333333335
523,2009-04-17,State of Play,60000000,37017955,88832210,2009,16,-22982045,28832210,State of Play,Thriller/Suspense,-0.38303408333333333
524,2006-04-21,The Sentinel,60000000,36280697,78080697,2006,16,-23719303,18080697,The Sentinel,Thriller/Suspense,-0.39532171666666666
525,2012-09-21,Trouble with the Curve,60000000,35763137,47818913,2012,38,-24236863,-12181087,Trouble with the Curve,Drama,-0.4039477166666667
526,2009-04-24,The Soloist,60000000,31853584,38522450,2009,17,-28146416,-21477550,The Soloist,Drama,-0.4691069333333333
527,2013-08-21,The Mortal Instruments: City of Bones,60000000,31165421,75965567,2013,34,-28834579,15965567,The Mortal Instruments: City of Bones,Adventure,-0.48057631666666667
528,2011-05-13,Priest,60000000,29136626,84154026,2011,19,-30863374,24154026,Priest,Horror,-0.5143895666666667
529,2006-09-15,The Black Dahlia,60000000,22672813,49238525,2006,37,-37327187,-10761475,The Black Dahlia,Thriller/Suspense,-0.6221197833333333
530,2008-12-25,The Spirit,60000000,19806188,39006188,2008,52,-40193812,-20993812,The Spirit,Action,-0.6698968666666667
531,2009-01-23,Inkheart,60000000,17303424,66655938,2009,4,-42696576,6655938,Inkheart,Adventure,-0.7116096
532,2006-09-22,Flyboys,60000000,13090630,14816379,2006,38,-46909370,-45183621,Flyboys,Drama,-0.7818228333333334
533,2014-02-14,Winter's Tale,60000000,12600231,29575033,2014,7,-47399769,-30424967,Winter's Tale,Drama,-0.78999615
534,2008-07-11,Meet Dave,60000000,11803254,50648806,2008,28,-48196746,-9351194,Meet Dave,Adventure,-0.8032791
535,2017-02-24,Rock Dog,60000000,9420546,24148488,2017,8,-50579454,-35851512,Rock Dog,Adventure,-0.8429909
536,2015-01-23,Mortdecai,60000000,7696134,30396134,2015,4,-52303866,-29603866,Mortdecai,Adventure,-0.8717311
537,2008-01-11,In the Name of the King: A Dungeon Siege Tale,60000000,4775656,13233220,2008,2,-55224344,-46766780,In the Name of the King: A Dungeon Siege Tale,Action,-0.9204057333333333
538,2016-02-05,Xi You Ji zhi Sun Wu Kong San Da Bai Gu Jing,60000000,709982,194058503,2016,5,-59290018,134058503,Xi You Ji zhi Sun Wu Kong San Da Bai Gu Jing,Action,-0.9881669666666667
539,2018-03-23,Sherlock Gnomes,59000000,43242871,87527651,2018,12,-15757129,28527651,Sherlock Gnomes,Adventure,-0.26706998305084745
540,2019-01-25,The Kid Who Would Be King,59000000,16790790,28296983,2019,4,-42209210,-30703017,The Kid Who Would Be King,Adventure,-0.7154103389830508
541,2016-02-12,Deadpool,58000000,363070709,801025593,2016,6,305070709,743025593,Deadpool,Action,5.259839810344827
542,2014-12-25,American Sniper,58000000,350126372,547326372,2014,52,292126372,489326372,American Sniper,Drama,5.036661586206897
543,2015-10-16,Goosebumps,58000000,80069458,158905324,2015,42,22069458,100905324,Goosebumps,Horror,0.3805078965517241
544,2012-01-20,Red Tails,58000000,49876377,50365498,2012,3,-8123623,-7634502,Red Tails,Action,-0.14006246551724139
545,2013-06-07,The Internship,58000000,44672764,93672764,2013,23,-13327236,35672764,The Internship,Comedy,-0.22977993103448277
546,2008-04-04,Leatherheads,58000000,31373938,41348628,2008,14,-26626062,-16651372,Leatherheads,Romantic Comedy,-0.4590700344827586
547,2017-03-24,Life,58000000,30234022,100929666,2017,12,-27765978,42929666,Life,Thriller/Suspense,-0.47872375862068967
548,2009-12-18,Did You Hear About the Morgans?,58000000,29580087,80480566,2009,51,-28419913,22480566,Did You Hear About the Morgans?,Romantic Comedy,-0.4899985
549,2008-12-12,"Che, Part 1: The Argentine",58000000,1802521,31627370,2008,50,-56197479,-26372630,"Che, Part 1: The Argentine",Drama,-0.9689220517241379
550,2008-05-30,Sex and the City,57500000,152647258,415247258,2008,22,95147258,357747258,Sex and the City,Comedy,1.6547349217391305
551,2010-09-10,Resident Evil: Afterlife,57500000,60128566,295874190,2010,36,2628566,238374190,Resident Evil: Afterlife,Horror,0.045714191304347826
552,2012-06-15,That's My Boy,57500000,36931089,58085235,2012,24,-20568911,585235,That's My Boy,Comedy,-0.35772019130434785
553,2012-02-17,Ghost Rider: Spirit of Vengeance,57000000,51774002,149217355,2012,7,-5225998,92217355,Ghost Rider: Spirit of Vengeance,Action,-0.09168417543859649
554,2014-12-25,Into the Woods,56200000,128002372,213116401,2014,52,71802372,156916401,Into the Woods,Musical,1.2776222775800712
555,2016-01-22,Zhuo yao ji,56000000,32766,359495591,2016,3,-55967234,303495591,Zhuo yao ji,Adventure,-0.9994148928571429
556,2007-12-14,Alvin and the Chipmunks,55000000,217326974,362605033,2007,50,162326974,307605033,Alvin and the Chipmunks,Adventure,2.951399527272727
557,2018-11-02,Bohemian Rhapsody,55000000,216303339,893745898,2018,44,161303339,838745898,Bohemian Rhapsody,Drama,2.9327879818181817
558,2006-12-15,The Pursuit of Happyness,55000000,162586036,307311093,2006,50,107586036,252311093,The Pursuit of Happyness,Drama,1.9561097454545455
559,2017-02-10,Fifty Shades Darker,55000000,114434010,381398492,2017,6,59434010,326398492,Fifty Shades Darker,Drama,1.0806183636363635
560,2013-10-11,Captain Phillips,55000000,107136417,220648184,2013,41,52136417,165648184,Captain Phillips,Drama,0.9479348545454546
561,2017-11-10,Murder on the Orient Express,55000000,102826543,345922730,2017,45,47826543,290922730,Murder on the Orient Express,Drama,0.8695735090909091
562,2014-09-26,The Equalizer,55000000,101530738,192903624,2014,39,46530738,137903624,The Equalizer,Action,0.8460134181818182
563,2018-02-09,Fifty Shades Freed,55000000,100407760,371350619,2018,6,45407760,316350619,Fifty Shades Freed,Drama,0.8255956363636363
564,2010-04-09,Date Night,55000000,98711404,152269033,2010,14,43711404,97269033,Date Night,Comedy,0.7947528
565,2015-01-16,Paddington,55000000,76223578,258789097,2015,3,21223578,203789097,Paddington,Adventure,0.38588323636363636
566,2006-04-28,R.V.,55000000,71724497,87473024,2006,17,16724497,32473024,R.V.,Adventure,0.30408176363636363
567,2011-06-17,Mr. Poppers's Penguins,55000000,68224452,189624452,2011,24,13224452,134624452,Mr. Poppers's Penguins,Adventure,0.24044458181818182
568,2013-11-01,Free Birds,55000000,55750480,110387072,2013,44,750480,55387072,Free Birds,Adventure,0.013645090909090909
569,2008-04-18,The Forbidden Kingdom,55000000,52075270,129075270,2008,16,-2924730,74075270,The Forbidden Kingdom,Action,-0.053176909090909094
570,2014-03-21,Muppets Most Wanted,55000000,51178893,79312301,2014,12,-3821107,24312301,Muppets Most Wanted,Adventure,-0.06947467272727273
571,2016-08-19,Kubo and the Two Strings,55000000,48023088,77548122,2016,33,-6976912,22548122,Kubo and the Two Strings,Adventure,-0.12685294545454545
572,2010-11-24,Burlesque,55000000,39440655,90552675,2010,47,-15559345,35552675,Burlesque,Drama,-0.2828971818181818
573,2008-10-24,Changeling,55000000,35739802,113805580,2008,43,-19260198,58805580,Changeling,Thriller/Suspense,-0.3501854181818182
574,2012-07-27,The Watch,55000000,34353000,67130045,2012,30,-20647000,12130045,The Watch,Comedy,-0.3754
575,2008-02-29,Semi-Pro,55000000,33479698,43980363,2008,9,-21520302,-11019637,Semi-Pro,Comedy,-0.3912782181818182
576,2018-02-23,Annihilation,55000000,32732301,43070915,2018,8,-22267699,-11929085,Annihilation,Thriller/Suspense,-0.4048672545454545
577,2015-10-16,Crimson Peak,55000000,31090320,74966854,2015,42,-23909680,19966854,Crimson Peak,Horror,-0.4347214545454545
578,2012-04-27,The Pirates! Band of Misfits,55000000,31051126,136143605,2012,17,-23948874,81143605,The Pirates! Band of Misfits,Adventure,-0.43543407272727275
579,2007-10-12,Elizabeth: The Golden Age,55000000,16285240,74870866,2007,41,-38714760,19870866,Elizabeth: The Golden Age,Drama,-0.7039047272727272
580,2009-06-12,Imagine That,55000000,16222392,22438144,2009,24,-38777608,-32561856,Imagine That,Adventure,-0.7050474181818182
581,2013-02-01,Bullet to the Head,55000000,9489829,22597969,2013,5,-45510171,-32402031,Bullet to the Head,Action,-0.8274576545454545
582,2006-09-22,All the King's Men,55000000,7221458,9521458,2006,38,-47778542,-45478542,All the King's Men,Drama,-0.8687007636363636
583,2007-05-04,Lucky You,55000000,5755286,6521829,2007,18,-49244714,-48478171,Lucky You,Drama,-0.8953584363636363
584,2006-07-14,"You, Me and Dupree",54000000,75802010,130402010,2006,28,21802010,76402010,"You, Me and Dupree",Comedy,0.4037409259259259
585,2008-12-19,Seven Pounds,54000000,69951824,166617328,2008,51,15951824,112617328,Seven Pounds,Drama,0.29540414814814814
586,2009-10-16,Law Abiding Citizen,53000000,73357727,131159781,2009,42,20357727,78159781,Law Abiding Citizen,Thriller/Suspense,0.38410805660377356
587,2015-09-18,Black Mass,53000000,62575678,98837872,2015,38,9575678,45837872,Black Mass,Drama,0.18067316981132076
588,2006-10-20,Flags of Our Fathers,53000000,33602376,63657941,2006,42,-19397624,10657941,Flags of Our Fathers,Drama,-0.36599290566037734
589,2007-04-06,Grindhouse,53000000,25031037,50187789,2007,14,-27968963,-2812211,Grindhouse,Horror,-0.527716283018868
590,2012-12-19,Zero Dark Thirty,52500000,95720716,134612435,2012,51,43220716,82112435,Zero Dark Thirty,Drama,0.8232517333333333
591,2008-07-18,Mamma Mia!,52000000,144130063,615748772,2008,29,92130063,563748772,Mamma Mia!,Musical,1.7717319807692307
592,2006-06-02,The Break-Up,52000000,118703275,205727307,2006,22,66703275,153727307,The Break-Up,Romantic Comedy,1.2827552884615385
593,2010-02-12,Valentine's Day,52000000,110485654,217569328,2010,6,58485654,165569328,Valentine's Day,Romantic Comedy,1.1247241153846155
594,2011-08-05,The Change-Up,52000000,37243418,75997067,2011,31,-14756582,23997067,The Change-Up,Comedy,-0.2837804230769231
595,2010-02-05,From Paris With Love,52000000,24077427,53139168,2010,5,-27922573,1139168,From Paris With Love,Thriller/Suspense,-0.5369725576923077
596,2006-08-04,Barnyard: The Original Party Animals,51000000,72779000,118583844,2006,31,21779000,67583844,Barnyard: The Original Party Animals,Adventure,0.4270392156862745
597,2006-11-22,Deck the Halls,51000000,35093569,46815807,2006,47,-15906431,-4184193,Deck the Halls,Comedy,-0.31189080392156865
598,2011-03-04,The Adjustment Bureau,50200000,62495645,126931325,2011,9,12295645,76731325,The Adjustment Bureau,Thriller/Suspense,0.2449331673306773
599,2009-11-20,The Twilight Saga: New Moon,50000000,296623634,687557727,2009,47,246623634,637557727,The Twilight Saga: New Moon,Drama,4.93247268
600,2012-06-29,Ted,50000000,218665740,556016627,2012,26,168665740,506016627,Ted,Adventure,3.3733148
601,2014-06-13,22 Jump Street,50000000,191719337,331333876,2014,24,141719337,281333876,22 Jump Street,Comedy,2.83438674
602,2016-06-17,Central Intelligence,50000000,127440871,217194805,2016,24,77440871,167194805,Central Intelligence,Comedy,1.54881742
603,2013-12-18,Anchorman 2: The Legend Continues,50000000,127352707,172185754,2013,51,77352707,122185754,Anchorman 2: The Legend Continues,Comedy,1.54705414
604,2011-06-10,Super 8,50000000,127004179,257972745,2011,23,77004179,207972745,Super 8,Thriller/Suspense,1.54008358
605,2018-11-21,Creed II,50000000,115715889,213591522,2018,47,65715889,163591522,Creed II,Drama,1.31431778
606,2018-02-09,Peter Rabbit,50000000,115234093,347132280,2018,6,65234093,297132280,Peter Rabbit,Adventure,1.30468186
607,2018-12-14,The Mule,50000000,103804407,170738684,2018,50,53804407,120738684,The Mule,Drama,1.07608814
608,2008-12-19,Yes Man,50000000,97690976,225990976,2008,51,47690976,175990976,Yes Man,Comedy,0.95381952
609,2014-02-28,Non-Stop,50000000,91742160,222383055,2014,9,41742160,172383055,Non-Stop,Action,0.8348432
610,2013-08-09,Disney Planes,50000000,90282580,238059569,2013,32,40282580,188059569,Disney Planes,Adventure,0.8056516
611,2006-03-10,Failure to Launch,50000000,88715192,128402901,2006,10,38715192,78402901,Failure to Launch,Romantic Comedy,0.77430384
612,2006-03-24,Inside Man,50000000,88634237,185798265,2006,12,38634237,135798265,Inside Man,Thriller/Suspense,0.77268474
613,2017-07-28,The Emoji Movie,50000000,86089513,216564840,2017,30,36089513,166564840,The Emoji Movie,Adventure,0.72179026
614,2011-07-29,"Crazy, Stupid, Love",50000000,84351197,147142328,2011,30,34351197,97142328,"Crazy, Stupid, Love",Comedy,0.68702394
615,2017-12-22,The Post,50000000,81903458,179748880,2017,51,31903458,129748880,The Post,Drama,0.63806916
616,2009-03-20,Knowing,50000000,79957634,186450317,2009,12,29957634,136450317,Knowing,Thriller/Suspense,0.59915268
617,2011-12-23,We Bought a Zoo,50000000,75624550,118729073,2011,51,25624550,68729073,We Bought a Zoo,Drama,0.512491
618,2011-09-23,Moneyball,50000000,75605492,111300835,2011,38,25605492,61300835,Moneyball,Drama,0.51210984
619,2006-03-17,V for Vendetta,50000000,70511035,130214162,2006,11,20511035,80214162,V for Vendetta,Action,0.4102207
620,2009-03-13,Race to Witch Mountain,50000000,67172595,105103784,2009,11,17172595,55103784,Race to Witch Mountain,Adventure,0.3434519
621,2014-07-18,Planes: Fire and Rescue,50000000,59157732,156399644,2014,29,9157732,106399644,Planes: Fire and Rescue,Adventure,0.18315464
622,2012-04-06,American Reunion,50000000,56758835,236799211,2012,14,6758835,186799211,American Reunion,Comedy,0.1351767
623,2013-01-25,Hansel & Gretel: Witch Hunters,50000000,55703475,214949716,2013,4,5703475,164949716,Hansel & Gretel: Witch Hunters,Action,0.1140695
624,2011-02-18,I am Number Four,50000000,55100437,146195159,2011,7,5100437,96195159,I am Number Four,Adventure,0.10200874
625,2016-01-15,13 Hours: The Secret Soldiers of Benghazi,50000000,52853219,69411370,2016,2,2853219,19411370,13 Hours: The Secret Soldiers of Benghazi,Drama,0.05706438
626,2017-09-29,American Made,50000000,51342000,135569212,2017,39,1342000,85569212,American Made,Thriller/Suspense,0.02684
627,2014-10-17,The Book of Life,50000000,50151543,97651543,2014,42,151543,47651543,The Book of Life,Adventure,0.00303086
628,2006-02-10,Firewall,50000000,48751189,82751189,2006,6,-1248811,32751189,Firewall,Thriller/Suspense,-0.02497622
629,2014-08-08,Into the Storm,50000000,47602194,150429371,2014,32,-2397806,100429371,Into the Storm,Thriller/Suspense,-0.04795612
630,2014-10-10,The Judge,50000000,47119388,76119388,2014,41,-2880612,26119388,The Judge,Drama,-0.05761224
631,2006-04-21,Silent Hill,50000000,46982632,94704227,2006,16,-3017368,44704227,Silent Hill,Horror,-0.06034736
632,2016-08-19,War Dogs,50000000,43034523,86234503,2016,33,-6965477,36234503,War Dogs,Comedy,-0.13930954
633,2009-11-25,Ninja Assassin,50000000,38122883,62209892,2009,48,-11877117,12209892,Ninja Assassin,Action,-0.23754234
634,2016-05-20,The Nice Guys,50000000,36261763,59596747,2016,20,-13738237,9596747,The Nice Guys,Black Comedy,-0.27476474
635,2010-06-04,Marmaduke,50000000,33644788,89895930,2010,22,-16355212,39895930,Marmaduke,Adventure,-0.32710424
636,2010-10-15,Hereafter,50000000,32746941,108660270,2010,41,-17253059,58660270,Hereafter,Thriller/Suspense,-0.34506118
637,2016-02-12,Zoolander 2,50000000,28848693,55348693,2016,6,-21151307,5348693,Zoolander 2,Comedy,-0.42302614
638,2009-01-16,Defiance,50000000,28644813,52987754,2009,3,-21355187,2987754,Defiance,Drama,-0.42710374
639,2007-02-09,Hannibal Rising,50000000,27669725,80583311,2007,6,-22330275,30583311,Hannibal Rising,Thriller/Suspense,-0.4466055
640,2013-03-29,The Host,50000000,26623701,64477051,2013,13,-23376299,14477051,The Host,Thriller/Suspense,-0.46752598
641,2015-03-13,Run All Night,50000000,26461644,66961644,2015,11,-23538356,16961644,Run All Night,Action,-0.47076712
642,2009-02-13,The International,50000000,25450527,53850527,2009,7,-24549473,3850527,The International,Thriller/Suspense,-0.49098946
643,2011-04-08,Your Highness,50000000,21596445,26121638,2011,14,-28403555,-23878362,Your Highness,Comedy,-0.5680711
644,2016-09-16,Snowden,50000000,21587519,35380918,2016,37,-28412481,-14619082,Snowden,Drama,-0.56824962
645,2011-09-30,Dream House,50000000,21302340,41642166,2011,39,-28697660,-8357834,Dream House,Horror,-0.5739532
646,2016-06-24,Free State of Jones,50000000,20810036,23237252,2016,25,-29189964,-26762748,Free State of Jones,Drama,-0.58379928
647,2009-09-04,Gamer,50000000,20534907,42002029,2009,36,-29465093,-7997971,Gamer,Action,-0.58930186
648,2013-02-14,Beautiful Creatures,50000000,19452138,60282876,2013,7,-30547862,10282876,Beautiful Creatures,Thriller/Suspense,-0.61095724
649,2007-09-14,Eastern Promises,50000000,17181265,56077088,2007,37,-32818735,6077088,Eastern Promises,Thriller/Suspense,-0.6563747
650,2011-02-25,Drive Angry,50000000,10721033,41042583,2011,8,-39278967,-8957417,Drive Angry,Action,-0.78557934
651,2009-02-27,Street Fighter: The Legend of Chun-Li,50000000,8742261,12660287,2009,9,-41257739,-37339713,Street Fighter: The Legend of Chun-Li,Action,-0.82515478
652,2018-02-16,Early Man,50000000,8267544,45285890,2018,7,-41732456,-4714110,Early Man,Adventure,-0.83464912
653,2009-11-13,The Boat That Rocked,50000000,8017467,37472651,2009,46,-41982533,-12527349,The Boat That Rocked,Comedy,-0.83965066
654,2015-04-17,Child 44,50000000,1224330,8004221,2015,16,-48775670,-41995779,Child 44,Thriller/Suspense,-0.9755134
655,2009-01-23,Outlander,50000000,166003,1250617,2009,4,-49833997,-48749383,Outlander,Adventure,-0.99667994
656,2013-03-15,Upside Down,50000000,102118,26387039,2013,11,-49897882,-23612961,Upside Down,Romantic Comedy,-0.99795764
657,2015-10-02,Shanghai,50000000,46425,15505922,2015,40,-49953575,-34494078,Shanghai,Drama,-0.9990715
658,2015-03-06,Chappie,49000000,31569268,105002056,2015,10,-17430732,56002056,Chappie,Action,-0.35572922448979594
659,2012-11-16,Anna Karenina,49000000,12816367,71004627,2012,46,-36183633,22004627,Anna Karenina,Drama,-0.7384414897959184
660,2015-01-09,Taken 3,48000000,89256424,327656424,2015,2,41256424,279656424,Taken 3,Action,0.8595088333333334
661,2018-11-16,Instant Family,48000000,67363237,119736188,2018,46,19363237,71736188,Instant Family,Comedy,0.4034007708333333
662,2010-01-22,Tooth Fairy,48000000,60022256,112610386,2010,3,12022256,64610386,Tooth Fairy,Adventure,0.25046366666666664
663,2007-09-07,3:10 to Yuma,48000000,53606916,71171825,2007,36,5606916,23171825,3:10 to Yuma,Western,0.11681075
664,2008-01-25,Rambo,47500000,42754105,112214531,2008,4,-4745895,64714531,Rambo,Action,-0.09991357894736842
665,2016-07-13,The Infiltrator,47500000,15436808,20718104,2016,28,-32063192,-26781896,The Infiltrator,Thriller/Suspense,-0.6750145684210527
666,2016-11-11,Arrival,47000000,100546139,203127894,2016,45,53546139,156127894,Arrival,Drama,1.1392795531914894
667,2009-04-22,Earth,47000000,32011576,116773317,2009,17,-14988424,69773317,Earth,Documentary,-0.31890263829787235
668,2007-01-05,Happily N'Ever After,47000000,15849032,37923818,2007,1,-31150968,-9076182,Happily N'Ever After,Adventure,-0.6627865531914894
669,2010-06-18,Jonah Hex,47000000,10547117,11022696,2010,24,-36452883,-35977304,Jonah Hex,Action,-0.7755932553191489
670,2016-12-23,Silence,46500000,7100177,23726626,2016,51,-39399823,-22773374,Silence,Drama,-0.8473080215053763
671,2013-11-01,Mr. Nobody,46500000,3622,22254,2013,44,-46496378,-46477746,Mr. Nobody,Drama,-0.9999221075268817
672,2013-09-20,Prisoners,46000000,61002302,113402302,2013,38,15002302,67402302,Prisoners,Thriller/Suspense,0.326137
673,2010-12-31,Arthur and the War of Two Worlds,45500000,347136,36180824,2010,52,-45152864,-9319176,Arthur and the War of Two Worlds,Adventure,-0.9923706373626373
674,2012-10-05,Taken 2,45000000,139854287,377807404,2012,40,94854287,332807404,Taken 2,Thriller/Suspense,2.1078730444444442
675,2017-12-22,Pitch Perfect 3,45000000,104897530,185736412,2017,51,59897530,140736412,Pitch Perfect 3,Comedy,1.3310562222222222
676,2008-07-11,Journey to the Center of the Earth,45000000,101704370,243180937,2008,28,56704370,198180937,Journey to the Center of the Earth,Adventure,1.260097111111111
677,2007-12-25,The Bucket List,45000000,93466502,174807445,2007,52,48466502,129807445,The Bucket List,Comedy,1.0770333777777779
678,2011-11-23,The Muppets,45000000,88625922,160971922,2011,47,43625922,115971922,The Muppets,Adventure,0.9694649333333333
679,2016-10-07,The Girl on the Train,45000000,75395035,174278214,2016,40,30395035,129278214,The Girl on the Train,Thriller/Suspense,0.6754452222222223
680,2010-03-19,The Bounty Hunter,45000000,67061228,135808837,2010,11,22061228,90808837,The Bounty Hunter,Romantic Comedy,0.4902495111111111
681,2006-01-20,Underworld: Evolution,45000000,62318875,113417762,2006,3,17318875,68417762,Underworld: Evolution,Action,0.3848638888888889
682,2016-12-09,Office Christmas Party,45000000,54767494,91323299,2016,49,9767494,46323299,Office Christmas Party,Comedy,0.2170554222222222
683,2007-09-21,Resident Evil: Extinction,45000000,50648679,149871103,2007,38,5648679,104871103,Resident Evil: Extinction,Action,0.1255262
684,2012-07-06,Savages,45000000,47323100,82513490,2012,27,2323100,37513490,Savages,Thriller/Suspense,0.051624444444444445
685,2014-05-23,Blended,45000000,46290741,127990741,2014,21,1290741,82990741,Blended,Romantic Comedy,0.028683133333333333
686,2017-06-16,All Eyez on Me,45000000,44922302,54876855,2017,24,-77698,9876855,All Eyez on Me,Drama,-0.0017266222222222223
687,2006-01-13,Last Holiday,45000000,38399961,43343247,2006,2,-6600039,-1656753,Last Holiday,Comedy,-0.14666753333333332
688,2006-03-03,16 Blocks,45000000,36895141,65595141,2006,9,-8104859,20595141,16 Blocks,Action,-0.1801079777777778
689,2006-07-28,The Ant Bully,45000000,28142535,49610898,2006,30,-16857465,4610898,The Ant Bully,Adventure,-0.3746103333333333
690,2009-07-31,Aliens in the Attic,45000000,25200412,59551283,2009,31,-19799588,14551283,Aliens in the Attic,Adventure,-0.4399908444444444
691,2007-09-14,Across the Universe,45000000,24343673,29367143,2007,37,-20656327,-15632857,Across the Universe,Musical,-0.4590294888888889
692,2008-12-26,Revolutionary Road,45000000,22951340,79604820,2008,52,-22048660,34604820,Revolutionary Road,Drama,-0.4899702222222222
693,2008-08-29,Babylon A.D.,45000000,22532572,70216497,2008,35,-22467428,25216497,Babylon A.D.,Action,-0.4992761777777778
694,2010-02-19,The Ghost Writer,45000000,15541549,65532491,2010,7,-29458451,20532491,The Ghost Writer,Thriller/Suspense,-0.6546322444444445
695,2008-09-05,Bangkok Dangerous,45000000,15298133,46598133,2008,36,-29701867,1598133,Bangkok Dangerous,Action,-0.6600414888888889
696,2012-09-21,Dredd,45000000,13414714,41467606,2012,38,-31585286,-3532394,Dredd,Action,-0.7018952444444444
697,2011-10-28,The Rum Diary,45000000,13109815,21544732,2011,43,-31890185,-23455268,The Rum Diary,Drama,-0.7086707777777778
698,2011-10-21,Johnny English Reborn,45000000,8406711,164640401,2011,42,-36593289,119640401,Johnny English Reborn,Adventure,-0.8131842
699,2008-09-26,Miracle at St. Anna,45000000,7916887,9676497,2008,39,-37083113,-35323503,Miracle at St. Anna,Drama,-0.8240691777777778
700,2006-12-21,Man cheng jin dai huang jin jia,45000000,6566773,76904429,2006,51,-38433227,31904429,Man cheng jin dai huang jin jia,Action,-0.8540717111111111
701,2007-11-16,Love in the Time of Cholera,45000000,4617608,31077418,2007,46,-40382392,-13922582,Love in the Time of Cholera,Drama,-0.8973864888888888
702,2012-12-31,Foodfight!,45000000,0,73706,2012,1,-45000000,-44926294,Foodfight!,Adventure,-1.0
703,2012-10-12,Argo,44500000,136025503,227140757,2012,41,91525503,182640757,Argo,Thriller/Suspense,2.0567528764044942
704,2010-07-30,Charlie St. Cloud,44000000,31206263,48478084,2010,30,-12793737,4478084,Charlie St. Cloud,Drama,-0.29076675
705,2014-02-06,The Interview,44000000,6105175,12342632,2014,6,-37894825,-31657368,The Interview,Comedy,-0.8612460227272727
706,2013-06-28,The Heat,43000000,159581587,229727774,2013,26,116581587,186727774,The Heat,Comedy,2.711199697674419
707,2017-01-06,A Monster Calls,43000000,3740823,46414530,2017,1,-39259177,3414530,A Monster Calls,Drama,-0.9130041162790697
708,2011-01-28,The Mechanic,42500000,29121498,76347393,2011,4,-13378502,33847393,The Mechanic,Action,-0.31478828235294115
709,2012-03-16,21 Jump Street,42000000,138447667,202812429,2012,11,96447667,160812429,21 Jump Street,Comedy,2.2963730238095237
710,2017-05-12,Snatched,42000000,45852178,57852177,2017,19,3852178,15852177,Snatched,Comedy,0.0917185238095238
711,2012-10-12,Here Comes the Boom,42000000,45290318,73239258,2012,41,3290318,31239258,Here Comes the Boom,Comedy,0.07834090476190476
712,2011-03-11,Red Riding Hood,42000000,37662162,91678442,2011,10,-4337838,49678442,Red Riding Hood,Thriller/Suspense,-0.10328185714285715
713,2018-12-25,Holmes & Watson,42000000,30568743,41926605,2018,52,-11431257,-73395,Holmes & Watson,Comedy,-0.2721727857142857
714,2012-01-27,One for the Money,42000000,26414527,36197221,2012,4,-15585473,-5802779,One for the Money,Comedy,-0.37108269047619047
715,2012-01-27,Man on a Ledge,42000000,18620000,49621440,2012,4,-23380000,7621440,Man on a Ledge,Thriller/Suspense,-0.5566666666666666
716,2010-12-03,The Warrior's Way,42000000,5666340,8514325,2010,48,-36333660,-33485675,The Warrior's Way,Western,-0.8650871428571428
717,2010-05-28,Micmacs,42000000,1259693,11756922,2010,21,-40740307,-30243078,Micmacs,Comedy,-0.9700073095238095
718,2011-10-14,The Big Year,41000000,7204138,7684524,2011,41,-33795862,-33315476,The Big Year,Comedy,-0.8242893170731708
719,2010-06-11,The Karate Kid,40000000,176591618,351774938,2010,23,136591618,311774938,The Karate Kid,Adventure,3.41479045
720,2015-02-13,Fifty Shades of Grey,40000000,166167230,570998101,2015,7,126167230,530998101,Fifty Shades of Grey,Drama,3.15418075
721,2009-06-19,The Proposal,40000000,163958031,314709717,2009,25,123958031,274709717,The Proposal,Romantic Comedy,3.098950775
722,2013-12-13,American Hustle,40000000,150117807,257878294,2013,50,110117807,217878294,American Hustle,Black Comedy,2.752945175
723,2014-07-25,Lucy,40000000,126573960,457507776,2014,30,86573960,417507776,Lucy,Action,2.164349
724,2013-12-25,Lone Survivor,40000000,125095601,149804632,2013,52,85095601,109804632,Lone Survivor,Action,2.127390025
725,2016-06-10,The Conjuring 2: The Enfield Poltergeist,40000000,102470008,311262102,2016,23,62470008,271262102,The Conjuring 2: The Enfield Poltergeist,Horror,1.5617502
726,2010-10-01,The Social Network,40000000,96962694,224922135,2010,39,56962694,184922135,The Social Network,Drama,1.42406735
727,2009-08-07,Julie & Julia,40000000,94125426,126646119,2009,32,54125426,86646119,Julie & Julia,Comedy,1.35313565
728,2009-02-06,He's Just Not That Into You,40000000,93953653,181053657,2009,6,53953653,141053657,He's Just Not That Into You,Romantic Comedy,1.348841325
729,2017-02-10,John Wick: Chapter Two,40000000,92029184,171317271,2017,6,52029184,131317271,John Wick: Chapter Two,Action,1.3007296
730,2016-01-15,Ride Along 2,40000000,90862685,124827316,2016,2,50862685,84827316,Ride Along 2,Comedy,1.271567125
731,2006-04-14,Scary Movie 4,40000000,90710620,178710620,2006,15,50710620,138710620,Scary Movie 4,Comedy,1.2677655
732,2015-03-27,Get Hard,40000000,90411453,106511453,2015,13,50411453,66511453,Get Hard,Comedy,1.260286325
733,2016-10-14,The Accountant,40000000,86260045,152962083,2016,41,46260045,112962083,The Accountant,Thriller/Suspense,1.156501125
734,2014-11-14,Dumb and Dumber To,40000000,86208010,156553592,2014,46,46208010,116553592,Dumb and Dumber To,Comedy,1.15520025
735,2014-04-25,The Other Woman,40000000,83911193,195111193,2014,17,43911193,155111193,The Other Woman,Comedy,1.097779825
736,2006-02-17,Eight Below,40000000,81612565,120455994,2006,7,41612565,80455994,Eight Below,Adventure,1.040314125
737,2015-09-25,The Intern,40000000,75764672,197115710,2015,39,35764672,157115710,The Intern,Comedy,0.8941168
738,2015-10-16,Bridge of Spies,40000000,72313754,162498338,2015,42,32313754,122498338,Bridge of Spies,Thriller/Suspense,0.80784385
739,2008-02-22,Vantage Point,40000000,72266306,150886329,2008,8,32266306,110886329,Vantage Point,Thriller/Suspense,0.80665765
740,2009-03-20,"I Love You, Man",40000000,72013010,92302502,2009,12,32013010,52302502,"I Love You, Man",Comedy,0.80032525
741,2006-01-27,Big Momma's House 2,40000000,70165972,137047376,2006,4,30165972,97047376,Big Momma's House 2,Comedy,0.7541493
742,2018-09-21,The House with a Clock in its Walls,40000000,68549695,126331750,2018,38,28549695,86331750,The House with a Clock in its Walls,Horror,0.713742375
743,2016-11-04,Hacksaw Ridge,40000000,67209615,168904682,2016,44,27209615,128904682,Hacksaw Ridge,Drama,0.680240375
744,2009-08-28,The Final Destination,40000000,66477700,187384627,2009,35,26477700,147384627,The Final Destination,Horror,0.6619425
745,2009-04-17,17 Again,40000000,64167069,139474906,2009,16,24167069,99474906,17 Again,Comedy,0.604176725
746,2011-02-18,Unknown,40000000,63686397,136123083,2011,7,23686397,96123083,Unknown,Thriller/Suspense,0.592159925
747,2010-06-04,Get Him to the Greek,40000000,61153526,91455875,2010,22,21153526,51455875,Get Him to the Greek,Comedy,0.52883815
748,2011-03-18,The Lincoln Lawyer,40000000,58009200,87145086,2011,11,18009200,47145086,The Lincoln Lawyer,Thriller/Suspense,0.45023
749,2006-08-25,Invincible,40000000,57806952,58501127,2006,34,17806952,18501127,Invincible,Drama,0.4451738
750,2013-02-15,Escape From Planet Earth,40000000,57012977,74156610,2013,7,17012977,34156610,Escape From Planet Earth,Adventure,0.425324425
751,2014-11-26,Horrible Bosses 2,40000000,54445357,105945357,2014,48,14445357,65945357,Horrible Bosses 2,Comedy,0.361133925
752,2006-10-20,The Prestige,40000000,53089891,104407366,2006,42,13089891,64407366,The Prestige,Thriller/Suspense,0.327247275
753,2006-06-16,The Lake House,40000000,52330111,114830111,2006,24,12330111,74830111,The Lake House,Drama,0.308252775
754,2010-07-09,Predators,40000000,52000688,127234389,2010,27,12000688,87234389,Predators,Action,0.3000172
755,2012-08-15,The Odd Life of Timothy Green,40000000,51853450,55249159,2012,33,11853450,15249159,The Odd Life of Timothy Green,Drama,0.29633625
756,2006-12-08,Apocalypto,40000000,50866635,121032272,2006,49,10866635,81032272,Apocalypto,Action,0.271665875
757,2007-02-14,Music and Lyrics,40000000,50572589,146196885,2007,7,10572589,106196885,Music and Lyrics,Romantic Comedy,0.264314725
758,2014-06-20,Jersey Boys,40000000,47047013,65282732,2014,25,7047013,25282732,Jersey Boys,Drama,0.176175325
759,2008-05-02,Made of Honor,40000000,46012734,106548738,2008,18,6012734,66548738,Made of Honor,Romantic Comedy,0.15031835
760,2014-05-30,A Million Ways to Die in The West,40000000,42720965,86778557,2014,22,2720965,46778557,A Million Ways to Die in The West,Comedy,0.068024125
761,2011-08-12,Final Destination 5,40000000,42587643,155011165,2011,32,2587643,115011165,Final Destination 5,Horror,0.064691075
762,2018-11-16,Widows,40000000,42402632,73866088,2018,46,2402632,33866088,Widows,Thriller/Suspense,0.0600658
763,2007-12-25,Aliens vs. Predator - Requiem,40000000,41797066,128884494,2007,52,1797066,88884494,Aliens vs. Predator - Requiem,Action,0.04492665
764,2007-12-25,The Water Horse: Legend of the Deep,40000000,40412817,103429755,2007,52,412817,63429755,The Water Horse: Legend of the Deep,Drama,0.010320425
765,2014-07-18,Sex Tape,40000000,38543473,126069509,2014,29,-1456527,86069509,Sex Tape,Comedy,-0.036413175
766,2011-04-15,Scream 4,40000000,38180928,95989590,2011,15,-1819072,55989590,Scream 4,Horror,-0.0454768
767,2011-03-18,Paul,40000000,37412945,101162106,2011,11,-2587055,61162106,Paul,Comedy,-0.064676375
768,2012-12-19,The Guilt Trip,40000000,37134215,41294674,2012,51,-2865785,1294674,The Guilt Trip,Comedy,-0.071644625
769,2011-08-26,Colombiana,40000000,36665854,72295262,2011,34,-3334146,32295262,Colombiana,Thriller/Suspense,-0.08335365
770,2018-01-12,The Commuter,40000000,36343858,101985431,2018,2,-3656142,61985431,The Commuter,Action,-0.09140355
771,2011-04-08,Arthur,40000000,33035397,47787943,2011,14,-6964603,7787943,Arthur,Comedy,-0.174115075
772,2008-03-21,Drillbit Taylor,40000000,32862104,49686263,2008,12,-7137896,9686263,Drillbit Taylor,Comedy,-0.1784474
773,2016-12-21,Patriots Day,40000000,31886361,52837989,2016,51,-8113639,12837989,Patriots Day,Thriller/Suspense,-0.202840975
774,2011-12-25,Extremely Loud and Incredibly Close,40000000,31847881,55247881,2011,51,-8152119,15247881,Extremely Loud and Incredibly Close,Drama,-0.203802975
775,2008-11-26,Transporter 3,40000000,31715062,107235592,2008,48,-8284938,67235592,Transporter 3,Action,-0.20712345
776,2010-11-10,Morning Glory,40000000,31011732,59795070,2010,45,-8988268,19795070,Morning Glory,Comedy,-0.2247067
777,2013-12-25,Grudge Match,40000000,29807260,69807260,2013,52,-10192740,29807260,Grudge Match,Comedy,-0.2548185
778,2017-08-11,The Nut Job 2: Nutty by Nature,40000000,28370522,57438389,2017,32,-11629478,17438389,The Nut Job 2: Nutty by Nature,Adventure,-0.29073695
779,2017-01-27,Resident Evil: The Final Chapter,40000000,26844692,314101190,2017,4,-13155308,274101190,Resident Evil: The Final Chapter,Action,-0.3288827
780,2008-02-29,The Other Boleyn Girl,40000000,26814957,78269970,2008,9,-13185043,38269970,The Other Boleyn Girl,Drama,-0.329626075
781,2017-06-30,The House,40000000,25584504,31192425,2017,26,-14415496,-8807575,The House,Comedy,-0.3603874
782,2007-04-05,The Reaping,40000000,25126214,62226214,2007,14,-14873786,22226214,The Reaping,Horror,-0.37184465
783,2011-01-07,Season of the Witch,40000000,24827228,91126600,2011,1,-15172772,51126600,Season of the Witch,Thriller/Suspense,-0.3793193
784,2016-08-26,Mechanic: Resurrection,40000000,21218403,109738840,2016,34,-18781597,69738840,Mechanic: Resurrection,Action,-0.469539925
785,2009-11-13,Fantastic Mr. Fox,40000000,21002919,47083412,2009,46,-18997081,7083412,Fantastic Mr. Fox,Adventure,-0.474927025
786,2012-02-03,Big Miracle,40000000,20157300,25268680,2012,5,-19842700,-14731320,Big Miracle,Drama,-0.4960675
787,2012-12-21,The Impossible,40000000,19019882,169590606,2012,51,-20980118,129590606,The Impossible,Drama,-0.52450295
788,2012-03-09,A Thousand Words,40000000,18450127,20790486,2012,10,-21549873,-19209514,A Thousand Words,Comedy,-0.538746825
789,2006-10-20,Marie Antoinette,40000000,15962471,60862471,2006,42,-24037529,20862471,Marie Antoinette,Drama,-0.600938225
790,2009-10-23,Amelia,40000000,14279575,19756077,2009,43,-25720425,-20243923,Amelia,Drama,-0.643010625
791,2009-10-23,Cirque du Freak: The Vampire's Assistant,40000000,14046595,39753957,2009,43,-25953405,-246043,Cirque du Freak: The Vampire's Assistant,Action,-0.648835125
792,2008-11-07,Soul Men,40000000,12082391,12345883,2008,45,-27917609,-27654117,Soul Men,Comedy,-0.697940225
793,2015-03-20,The Gunman,40000000,10664749,18594227,2015,12,-29335251,-21405773,The Gunman,Thriller/Suspense,-0.733381275
794,2009-09-25,Pandorum,40000000,10330853,17033431,2009,39,-29669147,-22966569,Pandorum,Horror,-0.741728675
795,2013-08-16,Paranoia,40000000,7388654,16340767,2013,33,-32611346,-23659233,Paranoia,Thriller/Suspense,-0.81528365
796,2015-07-10,Baahubali: The Beginning,40000000,6738000,26736665,2015,28,-33262000,-13263335,Baahubali: The Beginning,Action,-0.83155
797,2018-03-09,The Hurricane Heist,40000000,6115824,30963684,2018,10,-33884176,-9036316,The Hurricane Heist,Thriller/Suspense,-0.8471044
798,2015-11-25,Victor Frankenstein,40000000,5775076,31124367,2015,48,-34224924,-8875633,Victor Frankenstein,Thriller/Suspense,-0.8556231
799,2014-06-27,Snowpiercer,40000000,4563029,88069880,2014,26,-35436971,48069880,Snowpiercer,Thriller/Suspense,-0.885924275
800,2007-07-20,Sunshine,40000000,3688560,32030610,2007,29,-36311440,-7969390,Sunshine,Thriller/Suspense,-0.907786
801,2008-12-12,Delgo,40000000,915840,915840,2008,50,-39084160,-39084160,Delgo,Adventure,-0.977104
802,2007-09-07,The Hunting Party,40000000,876671,7729552,2007,36,-39123329,-32270448,The Hunting Party,Adventure,-0.978083225
803,2006-10-13,Alex Rider: Operation Stormbreaker,40000000,659210,20722450,2006,41,-39340790,-19277550,Alex Rider: Operation Stormbreaker,Action,-0.98351975
804,2009-11-20,Red Cliff,40000000,627047,119627047,2009,47,-39372953,79627047,Red Cliff,Action,-0.984323825
805,2007-03-16,Nomad,40000000,79123,79123,2007,11,-39920877,-39920877,Nomad,Drama,-0.998021925
806,2016-11-11,USS Indianapolis: Men of Courage,40000000,0,1663785,2016,45,-40000000,-38336215,USS Indianapolis: Men of Courage,Drama,-1.0
807,2014-12-31,Dragon Nest Warriors' Dawn,40000000,0,734423,2014,1,-40000000,-39265577,Dragon Nest Warriors' Dawn,Adventure,-1.0
808,2009-08-14,The Time Traveler's Wife,39000000,63414846,102332135,2009,33,24414846,63332135,The Time Traveler's Wife,Drama,0.6260216923076923
809,2007-02-02,Because I Said So,39000000,42674040,69538833,2007,5,3674040,30538833,Because I Said So,Comedy,0.09420615384615384
810,2012-10-05,Frankenweenie,39000000,35287788,81150788,2012,40,-3712212,42150788,Frankenweenie,Adventure,-0.09518492307692308
811,2005-09-30,Serenity,39000000,25514517,40319440,2005,39,-13485483,1319440,Serenity,Thriller/Suspense,-0.3457816153846154
812,2019-01-25,Serenity,25000000,8547045,12459828,2019,4,-16452955,-12540172,Serenity,Thriller/Suspense,-0.6581182
813,2007-09-07,Shoot 'Em Up,39000000,12796824,26796824,2007,36,-26203176,-12203176,Shoot 'Em Up,Action,-0.6718763076923077
814,2013-08-23,Yi dai zong shi,38600000,6594959,57987299,2013,34,-32005041,19387299,Yi dai zong shi,Action,-0.8291461398963731
815,2009-07-24,The Ugly Truth,38000000,88915214,205298907,2009,30,50915214,167298907,The Ugly Truth,Romantic Comedy,1.3398740526315789
816,2017-06-02,Captain Underpants: The First Epic Movie,38000000,73921000,126577874,2017,22,35921000,88577874,Captain Underpants: The First Epic Movie,Adventure,0.9452894736842106
817,2015-04-17,Paul Blart: Mall Cop 2,38000000,71091594,107650646,2015,16,33091594,69650646,Paul Blart: Mall Cop 2,Adventure,0.8708314210526316
818,2016-12-23,Why Him?,38000000,60323786,117425156,2016,51,22323786,79425156,Why Him?,Comedy,0.587468052631579
819,2011-04-22,Water for Elephants,38000000,58709717,116809717,2011,16,20709717,78809717,Water for Elephants,Drama,0.544992552631579
820,2010-10-08,Life as We Know It,38000000,53374681,105887837,2010,40,15374681,67887837,Life as We Know It,Romantic Comedy,0.40459686842105264
821,2013-09-06,Riddick,38000000,42025135,94763758,2013,36,4025135,56763758,Riddick,Action,0.10592460526315789
822,2016-01-22,The 5th Wave,38000000,34912982,111336398,2016,3,-3087018,73336398,The 5th Wave,Action,-0.08123731578947369
823,2009-02-06,Push,38000000,31811527,49678401,2009,6,-6188473,11678401,Push,Thriller/Suspense,-0.16285455263157894
824,2013-09-20,Rush,38000000,26947624,98230839,2013,38,-11052376,60230839,Rush,Drama,-0.290852
825,2017-10-20,Only the Brave,38000000,18340051,24555177,2017,42,-19659949,-13444823,Only the Brave,Drama,-0.5173670789473684
826,2011-10-14,The Thing,38000000,16999934,27573078,2011,41,-21000066,-10426922,The Thing,Horror,-0.5526333157894737
827,2008-10-10,City of Ember,38000000,7873007,17831558,2008,41,-30126993,-20168442,City of Ember,Adventure,-0.7928156052631579
828,2018-09-21,The Sisters Brothers,38000000,3143056,13133073,2018,38,-34856944,-24866927,The Sisters Brothers,Western,-0.917288
829,2008-08-26,Virgin Territory,38000000,0,5473041,2008,35,-38000000,-32526959,Virgin Territory,Drama,-1.0
830,2019-01-11,The Upside,37500000,108235497,119024536,2019,2,70735497,81524536,The Upside,Comedy,1.88627992
831,2012-05-18,What to Expect When You're Expecting,37500000,41152203,88473016,2012,20,3652203,50973016,What to Expect When You're Expecting,Romantic Comedy,0.09739208
832,2012-09-14,The Master,37500000,16247159,50647416,2012,37,-21252841,13147416,The Master,Drama,-0.5667424266666666
833,2008-10-10,The Express,37500000,9793406,9813309,2008,41,-27706594,-27686691,The Express,Drama,-0.7388425066666666
834,2008-11-21,Twilight,37000000,192769854,402280159,2008,47,155769854,365280159,Twilight,Drama,4.209996054054054
835,2013-08-07,We're the Millers,37000000,150394119,267816276,2013,32,113394119,230816276,We're the Millers,Comedy,3.0647059189189187
836,2015-11-25,Creed,37000000,109767581,173567581,2015,48,72767581,136567581,Creed,Drama,1.9666913783783784
837,2010-09-17,The Town,37000000,92186262,152566881,2010,37,55186262,115566881,The Town,Drama,1.4915205945945946
838,2011-09-23,Dolphin Tale,37000000,72286779,96068724,2011,38,35286779,59068724,Dolphin Tale,Drama,0.9536967297297297
839,2018-02-23,Game Night,37000000,69179066,117378084,2018,8,32179066,80378084,Game Night,Comedy,0.8697044864864865
840,2008-09-12,Burn After Reading,37000000,60355347,168167798,2008,37,23355347,131167798,Burn After Reading,Black Comedy,0.6312255945945946
841,2008-04-04,Nim's Island,37000000,48006762,101857425,2008,14,11006762,64857425,Nim's Island,Adventure,0.29748005405405403
842,2016-02-12,How to be Single,37000000,46843513,100003780,2016,6,9843513,63003780,How to be Single,Romantic Comedy,0.2660408918918919
843,2010-02-26,Cop Out,37000000,44875481,55909910,2010,8,7875481,18909910,Cop Out,Comedy,0.21285083783783784
844,2011-01-28,The Rite,37000000,33047633,97143987,2011,4,-3952367,60143987,The Rite,Horror,-0.10682072972972972
845,2008-07-18,Space Chimps,37000000,30105968,67029956,2008,29,-6894032,30029956,Space Chimps,Adventure,-0.1863251891891892
846,2015-05-29,Aloha,37000000,21052030,25387091,2015,22,-15947970,-11612909,Aloha,Drama,-0.43102621621621623
847,2009-12-31,Obitaemyy ostrov,36500000,0,15000000,2009,53,-36500000,-21500000,Obitaemyy ostrov,Action,-1.0
848,2018-10-05,A Star is Born,36000000,215288866,433410882,2018,40,179288866,397410882,A Star is Born,Drama,4.980246277777778
849,2011-02-11,Gnomeo and Juliet,36000000,99967670,193737977,2011,6,63967670,157737977,Gnomeo and Juliet,Comedy,1.7768797222222221
850,2010-03-26,Hot Tub Time Machine,36000000,50269859,65967750,2010,12,14269859,29967750,Hot Tub Time Machine,Comedy,0.39638497222222224
851,2014-09-12,Dolphin Tale 2,36000000,42024533,57824533,2014,37,6024533,21824533,Dolphin Tale 2,Drama,0.1673481388888889
852,2016-12-16,Collateral Beauty,36000000,31016021,85309093,2016,50,-4983979,49309093,Collateral Beauty,Drama,-0.13844386111111112
853,2016-01-22,Yip Man 3,36000000,2679437,157300954,2016,3,-33320563,121300954,Yip Man 3,Action,-0.9255711944444445
854,2011-05-06,There Be Dragons,36000000,1069334,4020990,2011,18,-34930666,-31979010,There Be Dragons,Drama,-0.9702962777777778
855,2017-04-14,Queen of the Desert,36000000,0,1578543,2017,15,-36000000,-34421457,Queen of the Desert,Drama,-1.0
856,2017-09-08,It,35000000,327481748,697457969,2017,36,292481748,662457969,It,Horror,8.356621371428572
857,2009-06-05,The Hangover,35000000,277322503,465764086,2009,23,242322503,430764086,The Hangover,Comedy,6.923500085714286
858,2009-11-20,The Blind Side,35000000,255959475,305705794,2009,47,220959475,270705794,The Blind Side,Drama,6.313127857142857
859,2010-12-22,True Grit,35000000,171243005,252276928,2010,51,136243005,217276928,True Grit,Western,3.892657285714286
860,2013-02-08,Identity Thief,35000000,134506920,175361578,2013,6,99506920,140361578,Identity Thief,Comedy,2.843054857142857
861,2006-06-30,The Devil Wears Prada,35000000,124740460,326073155,2006,26,89740460,291073155,The Devil Wears Prada,Comedy,2.5640131428571427
862,2011-07-08,Horrible Bosses,35000000,117538559,212417601,2011,27,82538559,177417601,Horrible Bosses,Comedy,2.358244542857143
863,2015-07-17,Trainwreck,35000000,110212700,141123897,2015,29,75212700,106123897,Trainwreck,Comedy,2.1489342857142857
864,2013-12-13,Saving Mr. Banks,35000000,83299761,114962525,2013,50,48299761,79962525,Saving Mr. Banks,Drama,1.3799931714285714
865,2008-03-28,21,35000000,81159365,159846429,2008,13,46159365,124846429,21,Thriller/Suspense,1.318839
866,2008-05-09,What Happens in Vegas...,35000000,80277646,218535708,2008,19,45277646,183535708,What Happens in Vegas...,Romantic Comedy,1.2936470285714285
867,2009-01-16,Hotel for Dogs,35000000,73178547,122357172,2009,3,38178547,87357172,Hotel for Dogs,Adventure,1.0908156285714286
868,2012-12-21,This is 40,35000000,67544505,90221182,2012,51,32544505,55221182,This is 40,Comedy,0.929843
869,2010-04-30,A Nightmare on Elm Street,35000000,63075011,117729621,2010,17,28075011,82729621,A Nightmare on Elm Street,Horror,0.8021431714285714
870,2006-04-07,The Benchwarmers,35000000,59843754,65063726,2006,14,24843754,30063726,The Benchwarmers,Comedy,0.7098215428571428
871,2010-10-08,Secretariat,35000000,59699513,60376247,2010,40,24699513,25376247,Secretariat,Drama,0.7057003714285714
872,2011-07-22,Friends with Benefits,35000000,55802754,146595891,2011,29,20802754,111595891,Friends with Benefits,Romantic Comedy,0.5943644
873,2016-05-20,Neighbors 2: Sorority Rising,35000000,55340730,108757621,2016,20,20340730,73757621,Neighbors 2: Sorority Rising,Comedy,0.5811637142857143
874,2007-03-23,TMNT,35000000,54149098,96096018,2007,12,19149098,61096018,TMNT,Action,0.5471170857142857
875,2018-06-29,Sicario: Day of the Soldado,35000000,50065850,75885196,2018,26,15065850,40885196,Sicario: Day of the Soldado,Action,0.43045285714285714
876,2009-11-25,Old Dogs,35000000,49492060,95104304,2009,48,14492060,60104304,Old Dogs,Comedy,0.4140588571428571
877,2015-05-22,Poltergeist,35000000,47425125,95713069,2015,21,12425125,60713069,Poltergeist,Horror,0.3550035714285714
878,2018-10-12,Goosebumps 2: Haunted Halloween,35000000,46697321,93291478,2018,41,11697321,58291478,Goosebumps 2: Haunted Halloween,Horror,0.3342091714285714
879,2018-01-19,12 Strong,35000000,45819713,71118378,2018,3,10819713,36118378,12 Strong,Drama,0.30913465714285715
880,2009-01-23,Underworld 3: Rise of the Lycans,35000000,45802315,89102315,2009,4,10802315,54102315,Underworld 3: Rise of the Lycans,Action,0.30863757142857146
881,2007-07-03,License to Wed,35000000,43799818,70187088,2007,27,8799818,35187088,License to Wed,Romantic Comedy,0.2514233714285714
882,2008-10-17,Max Payne,35000000,40689393,87775050,2008,42,5689393,52775050,Max Payne,Action,0.1625540857142857
883,2011-05-06,Something Borrowed,35000000,39046489,65084116,2011,18,4046489,30084116,Something Borrowed,Romantic Comedy,0.11561397142857142
884,2006-12-01,The Nativity Story,35000000,37629831,46309644,2006,48,2629831,11309644,The Nativity Story,Drama,0.07513802857142857
885,2011-10-28,In Time,35000000,37553932,165103952,2011,43,2553932,130103952,In Time,Thriller/Suspense,0.07296948571428571
886,2010-04-23,The Back-up Plan,35000000,37490007,75281179,2010,16,2490007,40281179,The Back-up Plan,Romantic Comedy,0.07114305714285714
887,2011-11-09,J. Edgar,35000000,37306030,84606030,2011,45,2306030,49606030,J. Edgar,Drama,0.06588657142857143
888,2018-08-17,Mile 22,35000000,36108758,66295121,2018,33,1108758,31295121,Mile 22,Action,0.0316788
889,2015-05-08,Hot Pursuit,35000000,34580201,45671512,2015,19,-419799,10671512,Hot Pursuit,Comedy,-0.011994257142857142
890,2015-12-25,Concussion,35000000,34531832,50363790,2015,52,-468168,15363790,Concussion,Drama,-0.013376228571428572
891,2017-10-13,The Foreigner,35000000,34393507,140783360,2017,41,-606493,105783360,The Foreigner,Action,-0.017328371428571427
892,2018-06-01,Adrift,35000000,31445011,57897191,2018,22,-3554989,22897191,Adrift,Drama,-0.10157111428571429
893,2008-08-15,Mirrors,35000000,30691439,77220596,2008,33,-4308561,42220596,Mirrors,Horror,-0.12310174285714286
894,2017-01-06,Underworld: Blood Wars,35000000,30353973,81209222,2017,1,-4646027,46209222,Underworld: Blood Wars,Action,-0.13274362857142857
895,2010-08-20,Nanny McPhee and the Big Bang,35000000,29197642,97799865,2010,33,-5802358,62799865,Nanny McPhee and the Big Bang,Adventure,-0.16578165714285714
896,2008-01-25,Untraceable,35000000,28687835,52649951,2008,4,-6312165,17649951,Untraceable,Thriller/Suspense,-0.18034757142857144
897,2011-09-23,Abduction,35000000,28087155,86648359,2011,38,-6912845,51648359,Abduction,Thriller/Suspense,-0.19750985714285715
898,2008-03-28,Superhero Movie,35000000,26638520,73026302,2008,13,-8361480,38026302,Superhero Movie,Comedy,-0.23889942857142857
899,2012-10-19,Alex Cross,35000000,25888412,35426759,2012,42,-9111588,426759,Alex Cross,Thriller/Suspense,-0.2603310857142857
900,2016-03-04,Whiskey Tango Foxtrot,35000000,23083334,25350747,2016,9,-11916666,-9649253,Whiskey Tango Foxtrot,Comedy,-0.34047617142857145
901,2015-08-21,Hitman: Agent 47,35000000,22467450,82182803,2015,34,-12532550,47182803,Hitman: Agent 47,Action,-0.35807285714285714
902,2008-07-25,The X-Files: I Want to Believe,35000000,20982478,68170792,2008,30,-14017522,33170792,The X-Files: I Want to Believe,Action,-0.4005006285714286
903,2012-08-24,Premium Rush,35000000,20275446,31393201,2012,34,-14724554,-3606799,Premium Rush,Thriller/Suspense,-0.42070154285714284
904,2013-01-18,Broken City,35000000,19701164,34480045,2013,3,-15298836,-519955,Broken City,Thriller/Suspense,-0.4371096
905,2007-12-21,Walk Hard: The Dewey Cox Story,35000000,18317151,20606053,2007,51,-16682849,-14393947,Walk Hard: The Dewey Cox Story,Comedy,-0.47665282857142854
906,2010-04-30,Furry Vengeance,35000000,17630465,39340177,2010,17,-17369535,4340177,Furry Vengeance,Adventure,-0.49627242857142856
907,2013-01-25,Parker,35000000,17616641,48543388,2013,4,-17383359,13543388,Parker,Thriller/Suspense,-0.4966674
908,2007-11-09,Lions for Lambs,35000000,14998070,63211088,2007,45,-20001930,28211088,Lions for Lambs,Drama,-0.5714837142857143
909,2011-05-27,The Tree of Life,35000000,13305665,61721826,2011,21,-21694335,26721826,The Tree of Life,Drama,-0.6198381428571429
910,2006-08-11,Zoom,35000000,11989328,12506188,2006,32,-23010672,-22493812,Zoom,Adventure,-0.6574477714285715
911,2009-12-18,The Young Victoria,35000000,11001272,31878891,2009,51,-23998728,-3121109,The Young Victoria,Drama,-0.6856779428571429
912,2014-03-28,Sabotage,35000000,10508518,18376443,2014,13,-24491482,-16623557,Sabotage,Action,-0.6997566285714286
913,2009-09-11,Whiteout,35000000,10275638,12254746,2009,37,-24724362,-22745254,Whiteout,Thriller/Suspense,-0.7064103428571429
914,2015-03-06,Unfinished Business,35000000,10219501,13214051,2015,10,-24780499,-21785949,Unfinished Business,Comedy,-0.7080142571428572
915,2015-09-30,The Walk,35000000,10161183,61492104,2015,40,-24838817,26492104,The Walk,Drama,-0.7096804857142858
916,2006-11-22,The Fountain,35000000,10144010,15461638,2006,47,-24855990,-19538362,The Fountain,Drama,-0.7101711428571429
917,2013-11-29,Mandela: Long Walk to Freedom,35000000,8323085,29890402,2013,48,-26676915,-5109598,Mandela: Long Walk to Freedom,Drama,-0.7621975714285715
918,2008-12-05,Punisher: War Zone,35000000,8050977,10157534,2008,49,-26949023,-24842466,Punisher: War Zone,Action,-0.7699720857142857
919,2006-11-10,A Good Year,35000000,7459300,42064105,2006,45,-27540700,7064105,A Good Year,Drama,-0.7868771428571428
920,2016-03-11,The Brothers Grimsby,35000000,6864016,28720470,2016,10,-28135984,-6279530,The Brothers Grimsby,Comedy,-0.8038852571428572
921,2017-10-20,The Snowman,35000000,6670765,43226146,2017,42,-28329235,8226146,The Snowman,Thriller/Suspense,-0.8094067142857143
922,2011-01-28,Biutiful,35000000,5101237,24687524,2011,4,-29898763,-10312476,Biutiful,Drama,-0.8542503714285714
923,2016-04-22,A Hologram for the King,35000000,4212494,11846010,2016,16,-30787506,-23153990,A Hologram for the King,Drama,-0.8796430285714286
924,2012-09-14,Stolen,35000000,289773,17967746,2012,37,-34710227,-17032254,Stolen,Action,-0.9917207714285714
925,2011-10-14,Trespass,35000000,16816,786532,2011,41,-34983184,-34213468,Trespass,Thriller/Suspense,-0.9995195428571428
926,2006-09-22,Bandidas,35000000,0,19282590,2006,38,-35000000,-15717410,Bandidas,Western,-1.0
927,2015-03-13,The Lovers,35000000,0,53899,2015,11,-35000000,-34946101,The Lovers,Adventure,-1.0
928,2011-12-25,The Darkest Hour,34800000,21443494,62831715,2011,51,-13356506,28031715,The Darkest Hour,Action,-0.3838076436781609
929,2017-06-28,Baby Driver,34000000,107825862,228104185,2017,26,73825862,194104185,Baby Driver,Thriller/Suspense,2.171348882352941
930,2014-09-19,The Maze Runner,34000000,102427862,348319861,2014,38,68427862,314319861,The Maze Runner,Thriller/Suspense,2.0125841764705883
931,2015-04-10,The Longest Ride,34000000,37446117,63802928,2015,15,3446117,29802928,The Longest Ride,Drama,0.10135638235294117
932,2009-08-14,Gake no ue no Ponyo,34000000,15090399,205312666,2009,33,-18909601,171312666,Gake no ue no Ponyo,Adventure,-0.5561647352941177
933,2014-09-05,Thunder and the House of Magic,34000000,4091,62582520,2014,36,-33995909,28582520,Thunder and the House of Magic,Adventure,-0.9998796764705883
934,2016-07-08,Mike and Dave Need Wedding Dates,33000000,46009673,75898100,2016,27,13009673,42898100,Mike and Dave Need Wedding Dates,Comedy,0.39423251515151514
935,2012-07-27,Step Up Revolution,33000000,35074677,165552290,2012,30,2074677,132552290,Step Up Revolution,Drama,0.062869
936,2006-08-18,Snakes on a Plane,33000000,34020814,62020814,2006,33,1020814,29020814,Snakes on a Plane,Thriller/Suspense,0.030933757575757576
937,2012-04-27,Safe,33000000,17142080,41495213,2012,17,-15857920,8495213,Safe,Action,-0.4805430303030303
938,2008-03-14,Doomsday,33000000,11008770,21621188,2008,11,-21991230,-11378812,Doomsday,Action,-0.6664009090909091
939,2006-05-12,Goal! The Dream Begins,33000000,4283255,27610873,2006,19,-28716745,-5389127,Goal! The Dream Begins,Drama,-0.870204393939394
940,2015-07-31,The Young and Prodigious T.S. Spivet,33000000,176847,357687,2015,31,-32823153,-32642313,The Young and Prodigious T.S. Spivet,Adventure,-0.994641
941,2015-10-30,Freaks of Nature,33000000,70958,70958,2015,44,-32929042,-32929042,Freaks of Nature,Black Comedy,-0.9978497575757576
942,2011-05-13,Bridesmaids,32500000,169211718,289632023,2011,19,136711718,257132023,Bridesmaids,Comedy,4.2065144
943,2008-12-10,The Reader,32500000,34194407,112964875,2008,50,1694407,80464875,The Reader,Drama,0.0521356
944,2013-04-26,The Big Wedding,32500000,21819348,48425971,2013,17,-10680652,15925971,The Big Wedding,Romantic Comedy,-0.32863544615384616
945,2012-02-24,Wanderlust,32500000,17288155,24159934,2012,8,-15211845,-8340066,Wanderlust,Comedy,-0.4680567692307692
946,2013-06-12,This is the End,32000000,101470202,126539117,2013,24,69470202,94539117,This is the End,Comedy,2.1709438125
947,2006-06-16,Nacho Libre,32000000,80197993,99296462,2006,24,48197993,67296462,Nacho Libre,Comedy,1.50618728125
948,2010-08-27,Takers,32000000,57744720,70587268,2010,34,25744720,38587268,Takers,Drama,0.8045225
949,2011-04-01,Source Code,32000000,54712227,140428499,2011,13,22712227,108428499,Source Code,Thriller/Suspense,0.70975709375
950,2018-04-20,I Feel Pretty,32000000,48795601,91553797,2018,16,16795601,59553797,I Feel Pretty,Comedy,0.52486253125
951,2011-02-18,"Big Mommas: Like Father, Like Son",32000000,37915414,82332450,2011,7,5915414,50332450,"Big Mommas: Like Father, Like Son",Comedy,0.1848566875
952,2007-02-23,The Number 23,32000000,35193167,77593167,2007,8,3193167,45593167,The Number 23,Thriller/Suspense,0.09978646875
953,2013-03-15,The Incredible Burt Wonderstone,32000000,22537881,27392609,2013,11,-9462119,-4607391,The Incredible Burt Wonderstone,Comedy,-0.29569121875
954,2018-10-12,Bad Times at the El Royale,32000000,17839115,29199399,2018,41,-14160885,-2800601,Bad Times at the El Royale,Thriller/Suspense,-0.44252765625
955,2010-09-03,Going the Distance,32000000,17804299,43603990,2010,35,-14195701,11603990,Going the Distance,Romantic Comedy,-0.44361565625
956,2010-03-19,Repo Men,32000000,13942007,18195238,2010,11,-18057993,-13804762,Repo Men,Action,-0.56431228125
957,2007-09-14,Dragon Wars: D-War,32000000,10977721,79915361,2007,37,-21022279,47915361,Dragon Wars: D-War,Action,-0.65694621875
958,2006-12-15,The Good German,32000000,1308696,6678033,2006,50,-30691304,-25321967,The Good German,Drama,-0.95910325
959,2016-04-15,Criminal,31500000,14708696,38771262,2016,15,-16791304,7271262,Criminal,Action,-0.5330572698412699
960,2013-04-12,42,31000000,95020213,97470701,2013,15,64020213,66470701,42,Drama,2.0651681612903228
961,2012-11-02,Flight,31000000,93772375,160558438,2012,44,62772375,129558438,Flight,Drama,2.0249153225806453
962,2014-03-07,The Grand Budapest Hotel,31000000,59076019,163981261,2014,10,28076019,132981261,The Grand Budapest Hotel,Comedy,0.9056780322580645
963,2015-07-29,Vacation,31000000,58884188,102306500,2015,31,27884188,71306500,Vacation,Comedy,0.899489935483871
964,2010-01-22,Extraordinary Measures,31000000,12482741,15826984,2010,3,-18517259,-15173016,Extraordinary Measures,Drama,-0.597330935483871
965,2017-08-25,Birth of the Dragon,31000000,6901965,7220490,2017,34,-24098035,-23779510,Birth of the Dragon,Action,-0.7773559677419355
966,2018-08-15,Crazy Rich Asians,30000000,174532921,238099711,2018,33,144532921,208099711,Crazy Rich Asians,Romantic Comedy,4.817764033333333
967,2012-02-10,The Vow,30000000,125014030,197618160,2012,6,95014030,167618160,The Vow,Drama,3.1671343333333333
968,2013-08-16,Lee Daniels' The Butler,30000000,116632095,177025498,2013,33,86632095,147025498,Lee Daniels' The Butler,Drama,2.8877365
969,2009-08-14,District 9,30000000,115646235,212453431,2009,33,85646235,182453431,District 9,Thriller/Suspense,2.8548745
970,2015-12-18,Sisters,30000000,87044645,106030660,2015,51,57044645,76030660,Sisters,Comedy,1.9014881666666668
971,2009-12-04,Up in the Air,30000000,83823381,166842739,2009,49,53823381,136842739,Up in the Air,Drama,1.7941127
972,2009-04-10,Hannah Montana the Movie,30000000,79576189,169173206,2009,15,49576189,139173206,Hannah Montana the Movie,Drama,1.6525396333333333
973,2008-01-18,27 Dresses,30000000,76808654,160247805,2008,3,46808654,130247805,27 Dresses,Romantic Comedy,1.5602884666666668
974,2012-09-28,Looper,30000000,66486205,170466405,2012,39,36486205,140466405,Looper,Action,1.2162068333333333
975,2013-02-01,Warm Bodies,30000000,66380662,115121608,2013,5,36380662,85121608,Warm Bodies,Romantic Comedy,1.2126887333333334
976,2014-01-17,The Nut Job,30000000,64251538,122529966,2014,3,34251538,92529966,The Nut Job,Adventure,1.1417179333333334
977,2012-08-08,Hope Springs,30000000,63536011,133085295,2012,32,33536011,103085295,Hope Springs,Romantic Comedy,1.1178670333333334
978,2008-04-18,Forgetting Sarah Marshall,30000000,63172463,105173042,2008,16,33172463,75173042,Forgetting Sarah Marshall,Comedy,1.1057487666666668
979,2008-04-25,Baby Mama,30000000,60494212,64170447,2008,17,30494212,34170447,Baby Mama,Comedy,1.0164737333333334
980,2009-01-09,Bride Wars,30000000,58715510,115150424,2009,2,28715510,85150424,Bride Wars,Comedy,0.9571836666666667
981,2011-05-20,Midnight in Paris,30000000,56816662,162502774,2011,20,26816662,132502774,Midnight in Paris,Romantic Comedy,0.8938887333333333
982,2017-11-22,Darkest Hour,30000000,56443120,150807172,2017,47,26443120,120807172,Darkest Hour,Drama,0.8814373333333333
983,2007-12-21,P.S. I Love You,30000000,53695808,155769678,2007,51,23695808,125769678,P.S. I Love You,Romantic Comedy,0.7898602666666666
984,2018-05-11,Life of the Party,30000000,53059911,65759911,2018,19,23059911,35759911,Life of the Party,Comedy,0.7686637
985,2010-05-14,Letters to Juliet,30000000,53032453,82148538,2010,19,23032453,52148538,Letters to Juliet,Drama,0.7677484333333333
986,2015-07-24,Southpaw,30000000,52421953,94156456,2015,30,22421953,64156456,Southpaw,Drama,0.7473984333333333
987,2017-07-28,Atomic Blonde,30000000,51573925,98345423,2017,30,21573925,68345423,Atomic Blonde,Thriller/Suspense,0.7191308333333334
988,2007-12-07,Atonement,30000000,50980159,129779728,2007,49,20980159,99779728,Atonement,Drama,0.6993386333333333
989,2015-09-18,Sicario,30000000,46889293,84393749,2015,38,16889293,54393749,Sicario,Thriller/Suspense,0.5629764333333334
990,2018-01-19,Den of Thieves,30000000,44947622,80131391,2018,3,14947622,50131391,Den of Thieves,Action,0.49825406666666666
991,2012-04-13,The Three Stooges,30000000,44338224,54052249,2012,15,14338224,24052249,The Three Stooges,Adventure,0.4779408
992,2014-10-24,John Wick,30000000,43037835,76206239,2014,43,13037835,46206239,John Wick,Action,0.4345945
993,2006-01-13,Glory Road,30000000,42647449,42799060,2006,2,12647449,12799060,Glory Road,Drama,0.4215816333333333
994,2015-04-24,The Age of Adaline,30000000,42629776,68984536,2015,17,12629776,38984536,The Age of Adaline,Drama,0.4209925333333333
995,2010-08-06,Step Up 3D,30000000,42400223,165889117,2010,31,12400223,135889117,Step Up 3D,Drama,0.4133407666666667
996,2009-05-29,Drag Me To Hell,30000000,42100625,91388487,2009,22,12100625,61388487,Drag Me To Hell,Horror,0.4033541666666667
997,2012-04-13,The Cabin in the Woods,30000000,42073277,70689968,2012,15,12073277,40689968,The Cabin in the Woods,Thriller/Suspense,0.40244256666666667
998,2006-11-10,Stranger Than Fiction,30000000,40435190,53572822,2006,45,10435190,23572822,Stranger Than Fiction,Comedy,0.34783966666666666
999,2011-04-08,Hanna,30000000,40259119,65343694,2011,14,10259119,35343694,Hanna,Drama,0.34197063333333333
1000,2007-10-19,30 Days of Night,30000000,39568996,80276156,2007,42,9568996,50276156,30 Days of Night,Horror,0.31896653333333336
1001,2006-09-15,Gridiron Gang,30000000,38432823,41457834,2006,37,8432823,11457834,Gridiron Gang,Drama,0.2810941
1002,2008-01-25,Meet the Spartans,30000000,38233676,84646831,2008,4,8233676,54646831,Meet the Spartans,Comedy,0.27445586666666666
1003,2013-09-13,The Family,30000000,36918811,51078541,2013,37,6918811,21078541,The Family,Black Comedy,0.23062703333333334
1004,2018-02-09,The 15:17 to Paris,30000000,36276286,56096200,2018,6,6276286,26096200,The 15:17 to Paris,Drama,0.20920953333333334
1005,2011-07-01,Larry Crowne,30000000,35608245,61449135,2011,26,5608245,31449135,Larry Crowne,Romantic Comedy,0.1869415
1006,2013-10-18,Carrie,30000000,35266619,82409520,2013,42,5266619,52409520,Carrie,Horror,0.17555396666666667
1007,2006-04-07,Take the Lead,30000000,34742066,65390493,2006,14,4742066,35390493,Take the Lead,Drama,0.15806886666666667
1008,2018-03-02,Death Wish,30000000,34017028,48575965,2018,9,4017028,18575965,Death Wish,Action,0.13390093333333333
1009,2010-11-24,Love and Other Drugs,30000000,32367005,102716321,2010,47,2367005,72716321,Love and Other Drugs,Drama,0.07890016666666666
1010,2015-06-03,Entourage,30000000,32363404,46438538,2015,23,2363404,16438538,Entourage,Comedy,0.07878013333333334
1011,2013-02-08,Side Effects,30000000,32172757,66742138,2013,6,2172757,36742138,Side Effects,Thriller/Suspense,0.07242523333333334
1012,2009-09-09,9,30000000,31749894,48559999,2009,37,1749894,18559999,9,Adventure,0.0583298
1013,2014-07-02,Deliver Us from Evil,30000000,30577122,87956618,2014,27,577122,57956618,Deliver Us from Evil,Horror,0.0192374
1014,2014-08-01,Get on Up,30000000,30569935,33339868,2014,31,569935,3339868,Get on Up,Drama,0.018997833333333332
1015,2012-04-27,The Five-Year Engagement,30000000,28700285,61623819,2012,17,-1299715,31623819,The Five-Year Engagement,Romantic Comedy,-0.04332383333333333
1016,2011-07-15,Winnie the Pooh,30000000,26692846,50145607,2011,28,-3307154,20145607,Winnie the Pooh,Adventure,-0.11023846666666667
1017,2018-09-14,White Boy Rick,30000000,24004833,25947983,2018,37,-5995167,-4052017,White Boy Rick,Drama,-0.1998389
1018,2011-02-04,Sanctum,30000000,23209310,108957098,2011,5,-6790690,78957098,Sanctum,Adventure,-0.22635633333333333
1019,2006-07-21,My Super Ex-Girlfriend,30000000,22530295,60772856,2006,29,-7469705,30772856,My Super Ex-Girlfriend,Comedy,-0.24899016666666668
1020,2017-08-25,Ballerina,30000000,21858070,96892829,2017,34,-8141930,66892829,Ballerina,Adventure,-0.27139766666666665
1021,2010-11-19,The Next Three Days,30000000,21148651,67255916,2010,46,-8851349,37255916,The Next Three Days,Thriller/Suspense,-0.2950449666666667
1022,2018-01-12,Proud Mary,30000000,20868638,21709539,2018,2,-9131362,-8290461,Proud Mary,Action,-0.3043787333333333
1023,2013-10-04,Runner Runner,30000000,19316646,60512680,2013,40,-10683354,30512680,Runner Runner,Thriller/Suspense,-0.3561118
1024,2017-04-28,Baahubali 2: The Conclusion,30000000,18985794,263502914,2017,17,-11014206,233502914,Baahubali 2: The Conclusion,Action,-0.3671402
1025,2006-03-03,Ultraviolet,30000000,18522064,30962112,2006,9,-11477936,962112,Ultraviolet,Action,-0.3825978666666667
1026,2011-08-19,Fright Night,30000000,18298649,40520649,2011,33,-11701351,10520649,Fright Night,Horror,-0.39004503333333335
1027,2017-09-15,mother!,30000000,17800004,42531076,2017,37,-12199996,12531076,mother!,Thriller/Suspense,-0.40666653333333336
1028,2015-10-09,Steve Jobs,30000000,17766658,35579007,2015,41,-12233342,5579007,Steve Jobs,Drama,-0.40777806666666666
1029,2010-06-04,Splice,30000000,17010170,28542494,2010,22,-12989830,-1457506,Splice,Horror,-0.4329943333333333
1030,2008-04-18,88 Minutes,30000000,16930884,32955399,2008,16,-13069116,2955399,88 Minutes,Thriller/Suspense,-0.4356372
1031,2008-10-24,Pride and Glory,30000000,15740721,43440721,2008,43,-14259279,13440721,Pride and Glory,Drama,-0.4753093
1032,2007-06-29,Evening,30000000,12406646,12885574,2007,26,-17593354,-17114426,Evening,Drama,-0.5864451333333334
1033,2013-01-18,The Last Stand,30000000,12050299,48330757,2013,3,-17949701,18330757,The Last Stand,Action,-0.5983233666666666
1034,2013-03-08,Dead Man Down,30000000,10895295,19599974,2013,10,-19104705,-10400026,Dead Man Down,Thriller/Suspense,-0.6368235
1035,2011-04-29,Hoodwinked Too: Hood vs. Evil,30000000,10143779,23353111,2011,17,-19856221,-6646889,Hoodwinked Too: Hood vs. Evil,Adventure,-0.6618740333333333
1036,2009-04-10,Dragonball Evolution,30000000,9362785,58228460,2009,15,-20637215,28228460,Dragonball Evolution,Adventure,-0.6879071666666666
1037,2017-04-14,The Lost City of Z,30000000,8574339,17121823,2017,15,-21425661,-12878177,The Lost City of Z,Action,-0.7141887
1038,2017-02-03,The Space Between Us,30000000,7885294,16481405,2017,5,-22114706,-13518595,The Space Between Us,Drama,-0.7371568666666667
1039,2009-12-25,The Imaginarium of Doctor Parnassus,30000000,7689607,64352607,2009,52,-22310393,34352607,The Imaginarium of Doctor Parnassus,Adventure,-0.7436797666666667
1040,2011-01-14,Barney's Version,30000000,7502560,8845575,2011,2,-22497440,-21154425,Barney's Version,Drama,-0.7499146666666666
1041,2018-08-31,Kin,30000000,5718096,10132644,2018,35,-24281904,-19867356,Kin,Action,-0.8093968
1042,2007-09-21,The Assassination of Jesse James by the Coward Robert Ford,30000000,3909149,15313631,2007,38,-26090851,-14686369,The Assassination of Jesse James by the Coward Robert Ford,Western,-0.8696950333333333
1043,2006-12-29,Miss Potter,30000000,3005605,35891257,2006,52,-26994395,5891257,Miss Potter,Drama,-0.8998131666666667
1044,2006-05-05,Wu ji,30000000,669625,35869934,2006,18,-29330375,5869934,Wu ji,Action,-0.9776791666666667
1045,2011-09-23,Machine Gun Preacher,30000000,538690,3721988,2011,38,-29461310,-26278012,Machine Gun Preacher,Drama,-0.9820436666666666
1046,2018-02-02,Bilal: A New Breed of Hero,30000000,490973,648599,2018,5,-29509027,-29351401,Bilal: A New Breed of Hero,Adventure,-0.9836342333333333
1047,2007-06-15,DOA: Dead or Alive,30000000,480314,7755686,2007,24,-29519686,-22244314,DOA: Dead or Alive,Action,-0.9839895333333334
1048,2010-02-19,Le Petit Nicolas,30000000,201857,52339566,2010,7,-29798143,22339566,Le Petit Nicolas,Adventure,-0.9932714333333333
1049,2011-10-07,Xinhai geming,30000000,135739,8593154,2011,40,-29864261,-21406846,Xinhai geming,Drama,-0.9954753666666667
1050,2008-02-21,Genghis Khan: To the Ends of the Earth and Sea,30000000,3892,4874498,2008,8,-29996108,-25125502,Genghis Khan: To the Ends of the Earth and Sea,Drama,-0.9998702666666667
1051,2015-01-30,Wild Card,30000000,3200,4315789,2015,5,-29996800,-25684211,Wild Card,Action,-0.9998933333333333
1052,2015-06-05,United Passions,30000000,918,168832,2015,23,-29999082,-29831168,United Passions,Drama,-0.9999694
1053,2010-12-31,Konferenz der Tiere,30000000,0,53048539,2010,52,-30000000,23048539,Konferenz der Tiere,Adventure,-1.0
1054,2015-12-01,Grace of Monaco,30000000,0,25199891,2015,49,-30000000,-4800109,Grace of Monaco,Drama,-1.0
1055,2016-03-08,Savva. Serdtse voyna,30000000,0,5015080,2016,10,-30000000,-24984920,Savva. Serdtse voyna,Adventure,-1.0
1056,2007-12-14,Goodbye Bafana,30000000,0,2717302,2007,50,-30000000,-27282698,Goodbye Bafana,Drama,-1.0
1057,2013-12-31,Space Pirate Captain Harlock,30000000,0,310985,2013,1,-30000000,-29689015,Space Pirate Captain Harlock,Adventure,-1.0
1058,2017-02-24,Collide,29200000,2280004,5466698,2017,8,-26919996,-23733302,Collide,Action,-0.9219176712328767
1059,2015-05-15,Pitch Perfect 2,29000000,184296230,287625468,2015,20,155296230,258625468,Pitch Perfect 2,Comedy,5.355042413793104
1060,2018-09-28,Night School,29000000,77339130,103008792,2018,39,48339130,74008792,Night School,Comedy,1.666866551724138
1061,2016-04-08,The Boss,29000000,63077560,78652207,2016,14,34077560,49652207,The Boss,Comedy,1.1750882758620689
1062,2017-08-18,Logan Lucky,29000000,27778642,44264271,2017,33,-1221358,15264271,Logan Lucky,Comedy,-0.042115793103448276
1063,2016-08-12,Florence Foster Jenkins,29000000,27383770,56000339,2016,32,-1616230,27000339,Florence Foster Jenkins,Drama,-0.05573206896551724
1064,2008-12-05,Frost/Nixon,29000000,18622031,28452945,2008,49,-10377969,-547055,Frost/Nixon,Drama,-0.357861
1065,2009-08-26,Taking Woodstock,29000000,7460204,10066366,2009,35,-21539796,-18933634,Taking Woodstock,Drama,-0.7427515862068965
1066,2015-08-14,Straight Outta Compton,28000000,161197785,202182981,2015,33,133197785,174182981,Straight Outta Compton,Drama,4.75706375
1067,2017-07-21,Girls Trip,28000000,115108515,140886353,2017,29,87108515,112886353,Girls Trip,Comedy,3.111018392857143
1068,2017-11-01,A Bad Moms Christmas,28000000,72110659,127710550,2017,44,44110659,99710550,A Bad Moms Christmas,Comedy,1.5753806785714286
1069,2013-02-14,Safe Haven,28000000,71399120,94050951,2013,7,43399120,66050951,Safe Haven,Drama,1.5499685714285714
1070,2015-12-11,The Big Short,28000000,70259870,133162752,2015,50,42259870,105162752,The Big Short,Drama,1.5092810714285714
1071,2008-11-07,Role Models,28000000,67300955,94500826,2008,45,39300955,66500826,Role Models,Comedy,1.4036055357142858
1072,2014-10-10,"Alexander and the Terrible, Horrible, No Good, Very Bad Day",28000000,66954149,101379287,2014,41,38954149,73379287,"Alexander and the Terrible, Horrible, No Good, Very Bad Day",Adventure,1.391219607142857
1073,2013-01-28,Last Vegas,28000000,63914167,112914167,2013,5,35914167,84914167,Last Vegas,Comedy,1.2826488214285714
1074,2018-06-15,Tag,28000000,54730625,77026186,2018,24,26730625,49026186,Tag,Comedy,0.9546651785714285
1075,2010-04-16,Kick-Ass,28000000,48071303,97531134,2010,15,20071303,69531134,Kick-Ass,Black Comedy,0.71683225
1076,2007-07-27,No Reservations,28000000,43107979,91943956,2007,30,15107979,63943956,No Reservations,Romantic Comedy,0.5395706785714286
1077,2011-08-12,30 Minutes or Less,28000000,37053924,40966716,2011,32,9053924,12966716,30 Minutes or Less,Comedy,0.3233544285714286
1078,2014-02-21,3 Days to Kill,28000000,30697999,38959900,2014,8,2697999,10959900,3 Days to Kill,Thriller/Suspense,0.09635710714285714
1079,2013-08-16,Kick-Ass 2,28000000,28795985,63129909,2013,33,795985,35129909,Kick-Ass 2,Action,0.028428035714285715
1080,2007-10-12,We Own the Night,28000000,28563179,55307857,2007,41,563179,27307857,We Own the Night,Drama,0.020113535714285716
1081,2014-09-19,A Walk Among the Tombstones,28000000,26017685,62108587,2014,38,-1982315,34108587,A Walk Among the Tombstones,Action,-0.07079696428571429
1082,2010-01-15,The Spy Next Door,28000000,24307106,46752858,2010,2,-3692894,18752858,The Spy Next Door,Adventure,-0.13188907142857142
1083,2014-04-25,Brick Mansions,28000000,20396829,73421224,2014,17,-7603171,45421224,Brick Mansions,Action,-0.2715418214285714
1084,2006-05-12,Just My Luck,28000000,17326650,38159905,2006,19,-10673350,10159905,Just My Luck,Romantic Comedy,-0.38119107142857145
1085,2015-08-21,American Ultra,28000000,14439985,30295028,2015,34,-13560015,2295028,American Ultra,Black Comedy,-0.48428625
1086,2016-02-05,Pride and Prejudice and Zombies,28000000,10907291,16638300,2016,5,-17092709,-11361700,Pride and Prejudice and Zombies,Black Comedy,-0.6104538928571429
1087,2015-10-30,Our Brand is Crisis,28000000,7002261,8594558,2015,44,-20997739,-19405442,Our Brand is Crisis,Drama,-0.74991925
1088,2008-10-03,How to Lose Friends & Alienate People,28000000,2775593,12031443,2008,40,-25224407,-15968557,How to Lose Friends & Alienate People,Comedy,-0.9008716785714286
1089,2007-12-31,Alatriste,28000000,0,22860477,2007,1,-28000000,-5139523,Alatriste,Adventure,-1.0
1090,2007-06-01,Knocked Up,27500000,148761765,219265952,2007,22,121261765,191765952,Knocked Up,Romantic Comedy,4.409518727272728
1091,2009-06-26,My Sister's Keeper,27500000,49200230,96673002,2009,26,21700230,69173002,My Sister's Keeper,Drama,0.7890992727272728
1092,2008-02-08,Welcome Home Roscoe Jenkins,27500000,42436517,43607627,2008,6,14936517,16107627,Welcome Home Roscoe Jenkins,Comedy,0.5431460727272728
1093,2012-01-13,Joyful Noise,27500000,30932113,31157914,2012,2,3432113,3657914,Joyful Noise,Musical,0.1248041090909091
1094,2006-12-25,Notes on a Scandal,27500000,17510118,50578411,2006,52,-9989882,23078411,Notes on a Scandal,Drama,-0.36326843636363637
1095,2007-10-19,Rendition,27500000,9736045,26939925,2007,42,-17763955,-560075,Rendition,Thriller/Suspense,-0.645962
1096,2011-10-28,Anonymous,27500000,4463292,15815509,2011,43,-23036708,-11684491,Anonymous,Thriller/Suspense,-0.8376984727272727
1097,2011-03-18,Limitless,27000000,79249455,155564919,2011,11,52249455,128564919,Limitless,Thriller/Suspense,1.935165
1098,2008-08-06,The Sisterhood of the Traveling Pants 2,27000000,44089964,44270131,2008,32,17089964,17270131,The Sisterhood of the Traveling Pants 2,Adventure,0.6329616296296297
1099,2016-05-13,Money Monster,27000000,41012075,93466095,2016,19,14012075,66466095,Money Monster,Thriller/Suspense,0.5189657407407408
1100,2011-08-19,Spy Kids: All the Time in the World,27000000,38536376,80681183,2011,33,11536376,53681183,Spy Kids: All the Time in the World,Adventure,0.4272731851851852
1101,2006-04-07,Lucky Number Slevin,27000000,22495466,55495466,2006,14,-4504534,28495466,Lucky Number Slevin,Thriller/Suspense,-0.1668345925925926
1102,2008-09-19,The Duchess,27000000,13848978,45160110,2008,38,-13151022,18160110,The Duchess,Drama,-0.4870748888888889
1103,2010-10-01,Case 39,27000000,13261851,28773827,2010,39,-13738149,1773827,Case 39,Horror,-0.5088203333333333
1104,2007-11-02,Martian Child,27000000,7500310,9352089,2007,44,-19499690,-17647911,Martian Child,Drama,-0.7222107407407408
1105,2008-10-17,What Just Happened,27000000,1090947,2412123,2008,42,-25909053,-24587877,What Just Happened,Comedy,-0.9595945555555555
1106,2009-01-16,Paul Blart: Mall Cop,26000000,146336178,185904750,2009,3,120336178,159904750,Paul Blart: Mall Cop,Adventure,4.628314538461538
1107,2008-08-06,Pineapple Express,26000000,87341380,102404019,2008,32,61341380,76404019,Pineapple Express,Comedy,2.359283846153846
1108,2013-04-26,Pain & Gain,26000000,49875291,81275291,2013,17,23875291,55275291,Pain & Gain,Action,0.918280423076923
1109,2010-01-22,Legion,26000000,40168080,67647574,2010,3,14168080,41647574,Legion,Thriller/Suspense,0.5449261538461538
1110,2012-08-29,Lawless,26000000,37397291,54393687,2012,35,11397291,28393687,Lawless,Drama,0.43835734615384614
1111,2009-12-04,Brothers,26000000,28544157,45043870,2009,49,2544157,19043870,Brothers,Drama,0.0978521923076923
1112,2009-12-04,Brothers,26000000,28544157,45043870,2009,49,2544157,19043870,Brothers,Action,0.0978521923076923
1113,2014-10-17,The Best of Me,26000000,26766213,41059418,2014,42,766213,15059418,The Best of Me,Drama,0.02946973076923077
1114,2012-04-27,The Raven,26000000,16008272,30601801,2012,17,-9991728,4601801,The Raven,Thriller/Suspense,-0.3842972307692308
1115,2015-07-10,Self/Less,26000000,12279691,33667319,2015,28,-13720309,7667319,Self/Less,Thriller/Suspense,-0.5277041923076923
1116,2013-10-18,The Fifth Estate,26000000,3254172,6154172,2013,42,-22745828,-19845828,The Fifth Estate,Drama,-0.8748395384615385
1117,2014-03-21,Blood Ties,26000000,42472,2923959,2014,12,-25957528,-23076041,Blood Ties,Drama,-0.9983664615384615
1118,2015-06-30,Viy,26000000,0,34246770,2015,27,-26000000,8246770,Viy,Adventure,-1.0
1119,2015-03-17,Accidental Love,26000000,0,135436,2015,12,-26000000,-25864564,Accidental Love,Comedy,-1.0
1120,2008-10-17,W.,25100000,25534493,28575778,2008,42,434493,3475778,W.,Drama,0.017310478087649402
1121,2011-08-10,The Help,25000000,169705587,213120004,2011,32,144705587,188120004,The Help,Drama,5.78822348
1122,2016-12-25,Hidden Figures,25000000,169607287,231771716,2016,51,144607287,206771716,Hidden Figures,Drama,5.78429148
1123,2008-12-12,Gran Torino,25000000,148095302,274543085,2008,50,123095302,249543085,Gran Torino,Drama,4.92381208
1124,2009-01-30,Taken,25000000,145000989,226941585,2009,5,120000989,201941585,Taken,Thriller/Suspense,4.80003956
1125,2014-01-17,Ride Along,25000000,134202565,153733800,2014,3,109202565,128733800,Ride Along,Comedy,4.3681026
1126,2007-02-16,Bridge to Terabithia,25000000,82234139,137984788,2007,7,57234139,112984788,Bridge to Terabithia,Drama,2.28936556
1127,2008-01-18,Cloverfield,25000000,80048433,171302226,2008,3,55048433,146302226,Cloverfield,Action,2.20193732
1128,2010-02-05,Dear John,25000000,80014842,142033509,2010,5,55014842,117033509,Dear John,Drama,2.20059368
1129,2012-12-25,Parental Guidance,25000000,77267296,120832383,2012,52,52267296,95832383,Parental Guidance,Adventure,2.09069184
1130,2007-11-09,No Country for Old Men,25000000,74273505,164035753,2007,45,49273505,139035753,No Country for Old Men,Action,1.9709402
1131,2011-01-21,No Strings Attached,25000000,70662220,149228078,2011,3,45662220,124228078,No Strings Attached,Romantic Comedy,1.8264888
1132,2012-01-13,Contraband,25000000,66528000,98406855,2012,2,41528000,73406855,Contraband,Action,1.66112
1133,2012-04-20,The Lucky One,25000000,60457138,96633833,2012,16,35457138,71633833,The Lucky One,Drama,1.41828552
1134,2006-06-06,The Omen,25000000,54607383,119295584,2006,23,29607383,94295584,The Omen,Horror,1.18429532
1135,2006-02-10,Final Destination 3,25000000,54098051,112798051,2006,6,29098051,87798051,Final Destination 3,Horror,1.16392204
1136,2011-04-22,Madea's Big Happy Family,25000000,53345287,54160818,2011,16,28345287,29160818,Madea's Big Happy Family,Drama,1.13381148
1137,2013-12-13,Tyler Perry's A Madea Christmas,25000000,52543354,52543354,2013,50,27543354,27543354,Tyler Perry's A Madea Christmas,Comedy,1.10173416
1138,2012-01-27,The Grey,25000000,51580136,81249176,2012,4,26580136,56249176,The Grey,Thriller/Suspense,1.06320544
1139,2008-08-22,The House Bunny,25000000,48237389,71390601,2008,34,23237389,46390601,The House Bunny,Comedy,0.92949556
1140,2006-01-27,Nanny McPhee,25000000,47279279,128745578,2006,4,22279279,103745578,Nanny McPhee,Adventure,0.89117116
1141,2014-08-15,The Giver,25000000,45090374,66540205,2014,33,20090374,41540205,The Giver,Drama,0.80361496
1142,2015-11-20,The Night Before,25000000,43035725,52427346,2015,47,18035725,27427346,The Night Before,Comedy,0.721429
1143,2007-12-26,There Will Be Blood,25000000,40222514,77208711,2007,52,15222514,52208711,There Will Be Blood,Drama,0.60890056
1144,2013-12-25,August: Osage County,25000000,37738810,50738810,2013,52,12738810,25738810,August: Osage County,Black Comedy,0.5095524
1145,2014-05-16,Million Dollar Arm,25000000,36447959,39217912,2014,20,11447959,14217912,Million Dollar Arm,Drama,0.45791836
1146,2018-09-07,Peppermint,25000000,35418723,51800758,2018,36,10418723,26800758,Peppermint,Action,0.41674892
1147,2007-09-21,Good Luck Chuck,25000000,35017297,59183821,2007,38,10017297,34183821,Good Luck Chuck,Romantic Comedy,0.40069188
1148,2006-03-17,She's the Man,25000000,33889159,55279608,2006,11,8889159,30279608,She's the Man,Romantic Comedy,0.35556636
1149,2014-12-10,The Gambler,25000000,33680992,38718031,2014,50,8680992,13718031,The Gambler,Drama,0.34723968
1150,2017-02-17,Fist Fight,25000000,32187017,40286416,2017,7,7187017,15286416,Fist Fight,Comedy,0.28748068
1151,2007-11-21,August Rush,25000000,31664162,65882103,2007,47,6664162,40882103,August Rush,Drama,0.26656648
1152,2011-12-09,The Sitter,25000000,30542576,38749404,2011,49,5542576,13749404,The Sitter,Comedy,0.22170304
1153,2014-04-11,Draft Day,25000000,28842237,29847480,2014,15,3842237,4847480,Draft Day,Drama,0.15368948
1154,2017-02-03,Rings,25000000,27793018,82917283,2017,5,2793018,57917283,Rings,Horror,0.11172072
1155,2009-05-22,Dance Flick,25000000,25794018,32224624,2009,21,794018,7224624,Dance Flick,Comedy,0.03176072
1156,2011-08-26,Don't Be Afraid of the Dark,25000000,24046682,39126427,2011,34,-953318,14126427,Don't Be Afraid of the Dark,Horror,-0.03813272
1157,2010-04-23,The Losers,25000000,23591432,29863840,2010,16,-1408568,4863840,The Losers,Action,-0.05634272
1158,2009-04-24,Fighting,25000000,23091010,32831707,2009,17,-1908990,7831707,Fighting,Action,-0.0763596
1159,2007-08-24,War,25000000,22486409,40686409,2007,34,-2513591,15686409,War,Action,-0.10054364
1160,2011-02-11,The Eagle,25000000,19490041,38993548,2011,6,-5509959,13993548,The Eagle,Action,-0.22039836
1161,2015-08-05,Shaun the Sheep,25000000,19375982,101925161,2015,32,-5624018,76925161,Shaun the Sheep,Adventure,-0.22496072
1162,2011-09-02,Shark Night 3D,25000000,18877153,18877153,2011,35,-6122847,-6122847,Shark Night 3D,Horror,-0.24491388
1163,2017-03-24,CHiPS,25000000,18600152,23190292,2017,12,-6399848,-1809708,CHiPS,Action,-0.25599392
1164,2017-12-22,Father Figures,25000000,17501244,21038441,2017,51,-7498756,-3961559,Father Figures,Comedy,-0.29995024
1165,2008-04-04,The Ruins,25000000,17432844,22910563,2008,14,-7567156,-2089437,The Ruins,Horror,-0.30268624
1166,2013-10-25,The Counselor,25000000,16973715,71009334,2013,43,-8026285,46009334,The Counselor,Thriller/Suspense,-0.3210514
1167,2006-12-08,Unaccompanied Minors,25000000,16655224,21970831,2006,49,-8344776,-3029169,Unaccompanied Minors,Adventure,-0.33379104
1168,2009-11-06,The Box,25000000,15051977,34356760,2009,45,-9948023,9356760,The Box,Thriller/Suspense,-0.39792092
1169,2010-10-08,My Soul to Take,25000000,14744435,16727470,2010,40,-10255565,-8272530,My Soul to Take,Horror,-0.4102226
1170,2008-08-15,Fly Me To the Moon,25000000,14543943,43530281,2008,33,-10456057,18530281,Fly Me To the Moon,Adventure,-0.41824228
1171,2007-08-03,Hot Rod,25000000,13938332,14334401,2007,31,-11061668,-10665599,Hot Rod,Comedy,-0.44246672
1172,2011-09-09,Warrior,25000000,13657115,24215385,2011,36,-11342885,-784615,Warrior,Drama,-0.4537154
1173,2017-09-22,Battle of the Sexes,25000000,12638526,18445379,2017,38,-12361474,-6554621,Battle of the Sexes,Drama,-0.49445896
1174,2012-12-21,Cirque du Soleil: Worlds Away,25000000,12512862,28012862,2012,51,-12487138,3012862,Cirque du Soleil: Worlds Away,Drama,-0.49948552
1175,2015-11-13,The 33,25000000,12227722,28400715,2015,46,-12772278,3400715,The 33,Drama,-0.51089112
1176,2011-04-15,The Conspirator,25000000,11538204,15907411,2011,15,-13461796,-9092589,The Conspirator,Drama,-0.53847184
1177,2008-03-28,Stop-Loss,25000000,10915744,11229035,2008,13,-14084256,-13770965,Stop-Loss,Drama,-0.56337024
1178,2011-09-16,Straw Dogs,25000000,10324441,11253821,2011,37,-14675559,-13746179,Straw Dogs,Thriller/Suspense,-0.58702236
1179,2009-11-25,The Road,25000000,8114270,29206732,2009,48,-16885730,4206732,The Road,Drama,-0.6754292
1180,2018-10-12,Beautiful Boy,25000000,7634767,13223014,2018,41,-17365233,-11776986,Beautiful Boy,Drama,-0.69460932
1181,2007-04-06,The Hoax,25000000,7164995,7164995,2007,14,-17835005,-17835005,The Hoax,Drama,-0.7134002
1182,2008-04-25,Deception,25000000,4598506,12850033,2008,17,-20401494,-12149967,Deception,Thriller/Suspense,-0.81605976
1183,2008-10-03,Blindness,25000000,3073392,20052958,2008,40,-21926608,-4947042,Blindness,Thriller/Suspense,-0.87706432
1184,2011-12-16,Carnage,25000000,2546747,38112154,2011,50,-22453253,13112154,Carnage,Drama,-0.89813012
1185,2017-09-01,Tulip Fever,25000000,2455635,6792768,2017,35,-22544365,-18207232,Tulip Fever,Drama,-0.9017746
1186,2006-01-06,BloodRayne,25000000,2405420,3711633,2006,1,-22594580,-21288367,BloodRayne,Action,-0.9037832
1187,2015-11-20,Legend,25000000,1872994,42425450,2015,47,-23127006,17425450,Legend,Thriller/Suspense,-0.92508024
1188,2009-11-20,Bad Lieutenant: Port of Call New Orleans,25000000,1702112,12413949,2009,47,-23297888,-12586051,Bad Lieutenant: Port of Call New Orleans,Drama,-0.93191552
1189,2016-01-29,Jane Got a Gun,25000000,1513793,3771345,2016,4,-23486207,-21228655,Jane Got a Gun,Western,-0.93944828
1190,2009-11-25,Me and Orson Welles,25000000,1190003,1190003,2009,48,-23809997,-23809997,Me and Orson Welles,Drama,-0.95239988
1191,2013-03-22,On the Road,25000000,720828,9313302,2013,12,-24279172,-15686698,On the Road,Drama,-0.97116688
1192,2012-08-24,Les petits mouchoirs,25000000,205505,48530887,2012,34,-24794495,23530887,Les petits mouchoirs,Comedy,-0.9917798
1193,2010-06-30,Love Ranch,25000000,137885,146149,2010,26,-24862115,-24853851,Love Ranch,Drama,-0.9944846
1194,2015-04-24,Yi ge ren de wu lin,25000000,129115,129115,2015,17,-24870885,-24870885,Yi ge ren de wu lin,Action,-0.9948354
1195,2010-12-31,Sammy's avonturen: De geheime doorgang,25000000,0,71594792,2010,52,-25000000,46594792,Sammy's avonturen: De geheime doorgang,Adventure,-1.0
1196,2010-12-31,Belka i Strelka. Zvezdnye sobaki,25000000,0,9445081,2010,52,-25000000,-15554919,Belka i Strelka. Zvezdnye sobaki,Adventure,-1.0
1197,2017-12-31,Matilda,25000000,0,9370285,2017,52,-25000000,-15629715,Matilda,Drama,-1.0
1198,2011-07-08,Ironclad,25000000,0,5297411,2011,27,-25000000,-19702589,Ironclad,Action,-1.0
1199,2015-03-10,Red Sky,25000000,0,91116,2015,11,-25000000,-24908884,Red Sky,Action,-1.0
1200,2012-11-09,Dangerous Liaisons,24200000,17000,10447579,2012,45,-24183000,-13752421,Dangerous Liaisons,Drama,-0.9992975206611571
1201,2006-12-20,Rocky Balboa,24000000,70269899,156229050,2006,51,46269899,132229050,Rocky Balboa,Drama,1.9279124583333334
1202,2014-06-20,Think Like a Man Too,24000000,65028687,70027933,2014,25,41028687,46027933,Think Like a Man Too,Romantic Comedy,1.709528625
1203,2016-12-16,Fences,24000000,57682904,64282881,2016,50,33682904,40282881,Fences,Drama,1.4034543333333334
1204,2011-10-14,Footloose,24000000,51802742,62989834,2011,41,27802742,38989834,Footloose,Musical,1.1584475833333334
1205,2017-04-07,Going in Style,24000000,45018541,78672579,2017,14,21018541,54672579,Going in Style,Comedy,0.8757725416666666
1206,2007-11-21,Hitman,24000000,39687694,99135571,2007,47,15687694,75135571,Hitman,Action,0.6536539166666666
1207,2009-11-06,The Men Who Stare at Goats,24000000,32428195,67348218,2009,45,8428195,43348218,The Men Who Stare at Goats,Black Comedy,0.35117479166666665
1208,2008-10-31,Zack and Miri Make a Porno,24000000,31457946,36856306,2008,44,7457946,12856306,Zack and Miri Make a Porno,Comedy,0.31074775
1209,2010-08-20,Piranha 3D,24000000,25003155,83660160,2010,33,1003155,59660160,Piranha 3D,Horror,0.041798125
1210,2010-11-24,Faster,24000000,23240020,35792945,2010,47,-759980,11792945,Faster,Action,-0.03166583333333333
1211,2011-09-16,I Don't Know How She Does It,24000000,9659074,24474463,2011,37,-14340926,474463,I Don't Know How She Does It,Comedy,-0.5975385833333333
1212,2013-12-20,Dhoom 3,24000000,8031955,11723620,2013,51,-15968045,-12276380,Dhoom 3,Action,-0.6653352083333334
1213,2009-10-02,Zombieland,23600000,75590286,102236596,2009,40,51990286,78636596,Zombieland,Comedy,2.202978220338983
1214,2018-11-16,Green Book,23000000,85080171,322983680,2018,46,62080171,299983680,Green Book,Comedy,2.6991378695652175
1215,2015-01-16,The Wedding Ringer,23000000,64460211,80171596,2015,3,41460211,57171596,The Wedding Ringer,Comedy,1.8026178695652173
1216,2011-10-07,The Ides of March,23000000,40962534,77735925,2011,40,17962534,54735925,The Ides of March,Drama,0.7809797391304348
1217,2014-01-10,Her,23000000,25568251,48163815,2014,2,2568251,25163815,Her,Drama,0.11166308695652175
1218,2012-02-17,Kari gurashi no Arietti,23000000,19192510,151496097,2012,7,-3807490,128496097,Kari gurashi no Arietti,Adventure,-0.16554304347826088
1219,2012-01-20,Haywire,23000000,18942396,36374700,2012,3,-4057604,13374700,Haywire,Thriller/Suspense,-0.1764175652173913
1220,2016-02-26,Eddie the Eagle,23000000,15789389,45060480,2016,8,-7210611,22060480,Eddie the Eagle,Drama,-0.3135048260869565
1221,2008-08-22,The Longshots,23000000,11511323,11778396,2008,34,-11488677,-11221604,The Longshots,Drama,-0.4995076956521739
1222,2007-09-14,In the Valley of Elah,23000000,6777741,24489150,2007,37,-16222259,1489150,In the Valley of Elah,Drama,-0.7053156086956521
1223,2009-09-25,Coco avant Chanel,23000000,6113834,50813834,2009,39,-16886166,27813834,Coco avant Chanel,Drama,-0.7341811304347826
1224,2013-06-28,Redemption,23000000,36686,13593473,2013,26,-22963314,-9406527,Redemption,Thriller/Suspense,-0.9984049565217391
1225,2008-04-25,Rogue,23000000,10452,4673377,2008,17,-22989548,-18326623,Rogue,Horror,-0.9995455652173914
1226,2011-03-15,Shi Yue Wei Cheng,23000000,0,44195779,2011,11,-23000000,21195779,Shi Yue Wei Cheng,Action,-1.0
1227,2007-06-22,1408,22500000,71985628,131263370,2007,25,49485628,108763370,1408,Horror,2.1993612444444444
1228,2016-11-18,Nocturnal Animals,22500000,10663357,32398681,2016,46,-11836643,9898681,Nocturnal Animals,Thriller/Suspense,-0.5260730222222222
1229,2015-04-24,The Water Diviner,22500000,4200117,31054727,2015,17,-18299883,8554727,The Water Diviner,Drama,-0.8133281333333333
1230,2007-09-28,The Game Plan,22000000,90648202,146590987,2007,39,68648202,124590987,The Game Plan,Comedy,3.120372818181818
1231,2014-02-28,Son of God,22000000,59700064,70949793,2014,9,37700064,48949793,Son of God,Drama,1.7136392727272727
1232,2014-08-08,The Hundred-Foot Journey,22000000,54235441,94270488,2014,32,32235441,72270488,The Hundred-Foot Journey,Romantic Comedy,1.4652473181818182
1233,2012-08-03,Diary of a Wimpy Kid: Dog Days,22000000,49008662,77229695,2012,31,27008662,55229695,Diary of a Wimpy Kid: Dog Days,Adventure,1.2276664545454545
1234,2009-09-18,The Informant!,22000000,33316821,41771168,2009,38,11316821,19771168,The Informant!,Thriller/Suspense,0.5144009545454545
1235,2013-11-22,Delivery Man,22000000,30659817,70536870,2013,47,8659817,48536870,Delivery Man,Comedy,0.39362804545454544
1236,2016-02-05,"Hail, Caesar!",22000000,30080225,64160680,2016,5,8080225,42160680,"Hail, Caesar!",Comedy,0.36728295454545457
1237,2008-08-27,Traitor,22000000,23530831,27882226,2008,35,1530831,5882226,Traitor,Thriller/Suspense,0.06958322727272727
1238,2017-05-19,Diary of a Wimpy Kid: The Long Haul,22000000,20738724,35609577,2017,20,-1261276,13609577,Diary of a Wimpy Kid: The Long Haul,Adventure,-0.05733072727272727
1239,2008-01-18,Mad Money,22000000,20668843,25044057,2008,3,-1331157,3044057,Mad Money,Comedy,-0.06050713636363637
1240,2013-11-27,Homefront,22000000,20158492,51695362,2013,48,-1841508,29695362,Homefront,Action,-0.0837049090909091
1241,2008-09-19,Igor,22000000,19528602,31013349,2008,38,-2471398,9013349,Igor,Adventure,-0.11233627272727273
1242,2015-09-04,The Transporter Refueled,22000000,16029670,69698495,2015,36,-5970330,47698495,The Transporter Refueled,Action,-0.27137863636363635
1243,2012-08-22,Hit & Run,22000000,13749300,17216955,2012,34,-8250700,-4783045,Hit & Run,Comedy,-0.3750318181818182
1244,2017-11-17,"Roman J. Israel, Esq.",22000000,11962712,12967012,2017,46,-10037288,-9032988,"Roman J. Israel, Esq.",Drama,-0.4562403636363636
1245,2013-12-04,Out of the Furnace,22000000,11330849,15434375,2013,49,-10669151,-6565625,Out of the Furnace,Drama,-0.48496140909090907
1246,2017-12-08,Just Getting Started,22000000,6069605,6756412,2017,49,-15930395,-15243588,Just Getting Started,Comedy,-0.7241088636363636
1247,2007-04-06,Zwartboek,22000000,4398532,27238354,2007,14,-17601468,5238354,Zwartboek,Thriller/Suspense,-0.8000667272727273
1248,2014-10-31,Before I Go to Sleep,22000000,3242457,19563579,2014,44,-18757543,-2436421,Before I Go to Sleep,Thriller/Suspense,-0.8526155909090909
1249,2010-10-08,Stone,22000000,1810078,4065020,2010,40,-20189922,-17934980,Stone,Drama,-0.9177237272727272
1250,2013-12-31,Metegol,22000000,0,34061097,2013,1,-22000000,12061097,Metegol,Adventure,-1.0
1251,2007-10-05,Michael Clayton,21500000,49033882,92987651,2007,40,27533882,71487651,Michael Clayton,Drama,1.2806456744186046
1252,2012-06-22,To Rome with Love,21500000,16684352,74326015,2012,25,-4815648,52826015,To Rome with Love,Romantic Comedy,-0.22398362790697673
1253,2012-11-16,Silver Linings Playbook,21000000,132092958,236412453,2012,46,111092958,215412453,Silver Linings Playbook,Drama,5.290140857142857
1254,2018-04-06,Blockers,21000000,60311495,94045328,2018,14,39311495,73045328,Blockers,Comedy,1.8719759523809525
1255,2010-04-16,Death at a Funeral,21000000,42739347,48977233,2010,15,21739347,27977233,Death at a Funeral,Comedy,1.035207
1256,2010-04-16,Death at a Funeral,21000000,42739347,48977233,2010,15,21739347,27977233,Death at a Funeral,Comedy,1.035207
1257,2007-08-17,Death at a Funeral,20000000,8580428,46790428,2007,33,-11419572,26790428,Death at a Funeral,Comedy,-0.5709786
1258,2007-08-17,Death at a Funeral,20000000,8580428,46790428,2007,33,-11419572,26790428,Death at a Funeral,Comedy,-0.5709786
1259,2010-11-05,For Colored Girls,21000000,37729698,38017873,2010,44,16729698,17017873,For Colored Girls,Drama,0.7966522857142857
1260,2007-01-05,Freedom Writers,21000000,36605602,43632609,2007,1,15605602,22632609,Freedom Writers,Drama,0.7431239047619047
1261,2017-08-04,Kidnap,21000000,30718107,34836080,2017,31,9718107,13836080,Kidnap,Thriller/Suspense,0.462767
1262,2008-03-14,Never Back Down,21000000,24850922,39319801,2008,11,3850922,18319801,Never Back Down,Action,0.1833772380952381
1263,2011-12-09,Tinker Tailor Soldier Spy,21000000,24149393,81452811,2011,49,3149393,60452811,Tinker Tailor Soldier Spy,Thriller/Suspense,0.14997109523809524
1264,2008-08-01,Swing Vote,21000000,16289867,17589867,2008,31,-4710133,-3410133,Swing Vote,Comedy,-0.2242920476190476
1265,2009-06-05,Away We Go,21000000,9451946,10108016,2009,23,-11548054,-10891984,Away We Go,Comedy,-0.5499073333333333
1266,2011-05-06,The Beaver,21000000,970816,5046038,2011,18,-20029184,-15953962,The Beaver,Comedy,-0.9537706666666667
1267,2017-02-24,Bitter Harvest,21000000,557241,606162,2017,8,-20442759,-20393838,Bitter Harvest,Drama,-0.9734647142857142
1268,2006-08-11,Pulse,20500000,20264436,30241435,2006,32,-235564,9741435,Pulse,Horror,-0.011490926829268293
1269,2016-12-09,La La Land,20000000,151101803,426351163,2016,49,131101803,406351163,La La Land,Musical,6.55509015
1270,2013-07-19,The Conjuring,20000000,137400141,318000141,2013,29,117400141,298000141,The Conjuring,Horror,5.87000705
1271,2017-11-17,Wonder,20000000,132422809,304604712,2017,46,112422809,284604712,Wonder,Drama,5.62114045
1272,2010-10-15,Jackass 3D,20000000,117229692,171685793,2010,41,97229692,151685793,Jackass 3D,Comedy,4.8614846
1273,2016-07-29,Bad Moms,20000000,113257297,180998716,2016,30,93257297,160998716,Bad Moms,Comedy,4.66286485
1274,2019-01-18,Glass,20000000,111035005,245303505,2019,3,91035005,225303505,Glass,Thriller/Suspense,4.55175025
1275,2008-10-03,Beverly Hills Chihuahua,20000000,94514402,154218168,2008,40,74514402,134218168,Beverly Hills Chihuahua,Adventure,3.7257201
1276,2014-07-02,Tammy,20000000,84525432,96407655,2014,27,64525432,76407655,Tammy,Comedy,3.2262716
1277,2011-11-16,The Descendants,20000000,82624961,175507800,2011,46,62624961,155507800,The Descendants,Drama,3.13124805
1278,2007-04-13,Disturbia,20000000,80818974,118537627,2007,15,60818974,98537627,Disturbia,Thriller/Suspense,3.0409487
1279,2009-04-24,Obsessed,20000000,68261644,73964713,2009,17,48261644,53964713,Obsessed,Thriller/Suspense,2.4130822
1280,2012-06-29,Tyler Perry's Madea's Witness Protection,20000000,65653242,66950887,2012,26,45653242,46950887,Tyler Perry's Madea's Witness Protection,Comedy,2.2826621
1281,2010-03-31,The Last Song,20000000,62950384,92678948,2010,13,42950384,72678948,The Last Song,Drama,2.1475192
1282,2010-04-02,Why Did I Get Married Too?,20000000,60095852,60831067,2010,13,40095852,40831067,Why Did I Get Married Too?,Drama,2.0047926
1283,2013-10-18,12 Years a Slave,20000000,56671993,181025343,2013,42,36671993,161025343,12 Years a Slave,Drama,1.83359965
1284,2016-06-03,Me Before You,20000000,56245075,208265198,2016,22,36245075,188265198,Me Before You,Drama,1.81225375
1285,2019-02-08,What Men Want,20000000,54611903,69911903,2019,6,34611903,49911903,What Men Want,Comedy,1.73059515
1286,2016-04-15,Barbershop: The Next Cut,20000000,54030051,54404202,2016,15,34030051,34404202,Barbershop: The Next Cut,Comedy,1.70150255
1287,2018-09-14,A Simple Favor,20000000,53548586,97628717,2018,37,33548586,77628717,A Simple Favor,Thriller/Suspense,1.6774293
1288,2015-01-09,Selma,20000000,52076908,66776576,2015,2,32076908,46776576,Selma,Drama,1.6038454
1289,2006-02-17,Date Movie,20000000,48548426,85146165,2006,7,28548426,65146165,Date Movie,Comedy,1.4274213
1290,2007-03-16,Premonition,20000000,47852604,81461343,2007,11,27852604,61461343,Premonition,Thriller/Suspense,1.3926302
1291,2015-11-06,Spotlight,20000000,45055776,92088460,2015,45,25055776,72088460,Spotlight,Drama,1.2527888
1292,2018-03-30,Acrimony,20000000,43549096,46627836,2018,13,23549096,26627836,Acrimony,Thriller/Suspense,1.1774548
1293,2015-06-26,Max,20000000,42656255,43658157,2015,26,22656255,23658157,Max,Adventure,1.13281275
1294,2008-03-21,Meet the Browns,20000000,41975388,41975388,2008,12,21975388,21975388,Meet the Browns,Comedy,1.0987694
1295,2009-07-24,Orphan,20000000,41596251,78769428,2009,30,21596251,58769428,Orphan,Drama,1.07981255
1296,2017-11-17,The Star,20000000,40847995,62758010,2017,46,20847995,42758010,The Star,Adventure,1.04239975
1297,2007-01-26,Epic Movie,20000000,39739367,86858578,2007,4,19739367,66858578,Epic Movie,Comedy,0.98696835
1298,2008-09-19,Lakeview Terrace,20000000,39263506,44821299,2008,38,19263506,24821299,Lakeview Terrace,Thriller/Suspense,0.9631753
1299,2006-10-13,The Grudge 2,20000000,39143839,70743839,2006,41,19143839,50743839,The Grudge 2,Horror,0.95719195
1300,2016-07-27,Nerve,20000000,38583626,70652284,2016,30,18583626,50652284,Nerve,Thriller/Suspense,0.9291813
1301,2006-10-13,Man of the Year,20000000,37442180,41342180,2006,41,17442180,21342180,Man of the Year,Comedy,0.872109
1302,2016-02-19,Risen,20000000,36880033,46255763,2016,7,16880033,26255763,Risen,Drama,0.84400165
1303,2010-08-18,Vampires Suck,20000000,36661504,81424988,2010,33,16661504,61424988,Vampires Suck,Comedy,0.8330752
1304,2010-09-01,The American,20000000,35606376,67950723,2010,35,15606376,47950723,The American,Thriller/Suspense,0.7803188
1305,2011-11-04,A Very Harold & Kumar 3D Christmas,20000000,35061031,36265745,2011,44,15061031,16265745,A Very Harold & Kumar 3D Christmas,Comedy,0.75305155
1306,2013-01-04,Texas Chainsaw 3D,20000000,34341945,47666013,2013,1,14341945,27666013,Texas Chainsaw 3D,Horror,0.71709725
1307,2006-10-27,Babel,20000000,34302837,132121212,2006,43,14302837,112121212,Babel,Drama,0.71514185
1308,2014-09-19,This is Where I Leave You,20000000,34296320,41296320,2014,38,14296320,21296320,This is Where I Leave You,Comedy,0.714816
1309,2008-12-12,Doubt,20000000,33446470,53191101,2008,50,13446470,33191101,Doubt,Drama,0.6723235
1310,2013-04-12,Scary Movie V,20000000,32015787,78613981,2013,15,12015787,58613981,Scary Movie V,Comedy,0.60078935
1311,2010-03-12,She's Out of My League,20000000,32010860,48680977,2010,10,12010860,28680977,She's Out of My League,Romantic Comedy,0.600543
1312,2008-11-26,Milk,20000000,31841299,57293371,2008,48,11841299,37293371,Milk,Drama,0.59206495
1313,2011-08-31,The Debt,20000000,31177548,46604054,2011,35,11177548,26604054,The Debt,Thriller/Suspense,0.5588774
1314,2010-01-08,Daybreakers,20000000,30101577,51445503,2010,1,10101577,31445503,Daybreakers,Horror,0.50507885
1315,2008-03-07,The Bank Job,20000000,30060660,66143005,2008,10,10060660,46143005,The Bank Job,Thriller/Suspense,0.503033
1316,2009-10-16,The Stepfather,20000000,29062561,29227561,2009,42,9062561,9227561,The Stepfather,Thriller/Suspense,0.45312805
1317,2006-04-28,Stick It,20000000,26910736,30399714,2006,17,6910736,10399714,Stick It,Comedy,0.3455368
1318,2008-01-04,One Missed Call,20000000,26890041,44513466,2008,1,6890041,24513466,One Missed Call,Horror,0.34450205
1319,2008-04-11,Street Kings,20000000,26418667,65457811,2008,15,6418667,45457811,Street Kings,Thriller/Suspense,0.32093335
1320,2013-08-23,The World's End,20000000,26004851,47508505,2013,34,6004851,27508505,The World's End,Comedy,0.30024255
1321,2010-09-24,You Again,20000000,25702053,32838945,2010,38,5702053,12838945,You Again,Comedy,0.28510265
1322,2007-06-15,Nancy Drew,20000000,25584685,30703845,2007,24,5584685,10703845,Nancy Drew,Thriller/Suspense,0.27923425
1323,2010-09-17,Alpha and Omega 3D,20000000,25107267,48958353,2010,37,5107267,28958353,Alpha and Omega 3D,Adventure,0.25536335
1324,2014-02-14,Endless Love,20000000,23438250,34718173,2014,7,3438250,14718173,Endless Love,Drama,0.1719125
1325,2006-09-08,The Covenant,20000000,23364784,38164784,2006,36,3364784,18164784,The Covenant,Thriller/Suspense,0.1682392
1326,2011-07-01,Monte Carlo,20000000,23186769,39686769,2011,26,3186769,19686769,Monte Carlo,Romantic Comedy,0.15933845
1327,2006-03-24,Stay Alive,20000000,23086480,23187506,2006,12,3086480,3187506,Stay Alive,Horror,0.154324
1328,2017-06-16,Rough Night,20000000,22105643,46844357,2017,24,2105643,26844357,Rough Night,Black Comedy,0.10528215
1329,2009-08-21,Shorts,20000000,20919166,29870801,2009,34,919166,9870801,Shorts,Adventure,0.0459583
1330,2008-09-19,Appaloosa,20000000,20211394,27911453,2008,38,211394,7911453,Appaloosa,Western,0.0105697
1331,2015-11-20,Secret in Their Eyes,20000000,20180155,32608019,2015,47,180155,12608019,Secret in Their Eyes,Thriller/Suspense,0.00900775
1332,2007-03-23,Reign Over Me,20000000,19661987,20081987,2007,12,-338013,81987,Reign Over Me,Drama,-0.01690065
1333,2008-09-19,My Best Friend's Girl,20000000,19219250,34787111,2008,38,-780750,14787111,My Best Friend's Girl,Comedy,-0.0390375
1334,2007-05-11,Georgia Rule,20000000,18882880,20819601,2007,19,-1117120,819601,Georgia Rule,Drama,-0.055856
1335,2007-09-21,Into the Wild,20000000,18354356,56822960,2007,38,-1645644,36822960,Into the Wild,Drama,-0.0822822
1336,2006-09-29,School for Scoundrels,20000000,17807569,17807569,2006,39,-2192431,-2192431,School for Scoundrels,Comedy,-0.10962155
1337,2012-10-26,Silent Hill: Revelation 3D,20000000,17530219,55975672,2012,43,-2469781,35975672,Silent Hill: Revelation 3D,Horror,-0.12348905
1338,2009-02-20,Fired Up,20000000,17231291,18608570,2009,8,-2768709,-1391430,Fired Up,Comedy,-0.13843545
1339,2017-09-29,Flatliners,20000000,16883115,45173738,2017,39,-3116885,25173738,Flatliners,Thriller/Suspense,-0.15584425
1340,2007-03-16,Dead Silence,20000000,16574590,20614661,2007,11,-3425410,614661,Dead Silence,Horror,-0.1712705
1341,2009-12-04,Armored,20000000,15988876,23661038,2009,49,-4011124,3661038,Armored,Thriller/Suspense,-0.2005562
1342,2007-12-14,The Kite Runner,20000000,15800078,74180745,2007,50,-4199922,54180745,The Kite Runner,Drama,-0.2099961
1343,2009-09-23,Capitalism: A Love Story,20000000,14363397,19121531,2009,39,-5636603,-878469,Capitalism: A Love Story,Documentary,-0.28183015
1344,2012-04-13,Lockout,20000000,14326865,33943049,2012,15,-5673135,13943049,Lockout,Thriller/Suspense,-0.28365675
1345,2008-08-29,Disaster Movie,20000000,14190901,36720752,2008,35,-5809099,16720752,Disaster Movie,Comedy,-0.29045495
1346,2011-09-30,What's Your Number?,20000000,14011084,30163785,2011,39,-5988916,10163785,What's Your Number?,Romantic Comedy,-0.2994458
1347,2009-04-17,Crank 2: High Voltage,20000000,13684249,35472739,2009,16,-6315751,15472739,Crank 2: High Voltage,Thriller/Suspense,-0.31578755
1348,2015-10-30,Burnt,20000000,13651946,36773510,2015,44,-6348054,16773510,Burnt,Comedy,-0.3174027
1349,2006-10-13,One Night with the King,20000000,13395961,13725032,2006,41,-6604039,-6274968,One Night with the King,Drama,-0.33020195
1350,2008-09-19,Ghost Town,20000000,13367624,29958228,2008,38,-6632376,9958228,Ghost Town,Romantic Comedy,-0.3316188
1351,2016-02-26,Triple 9,20000000,12639297,25943792,2016,8,-7360703,5943792,Triple 9,Thriller/Suspense,-0.36803515
1352,2016-09-02,The Light Between Oceans,20000000,12545979,22281732,2016,35,-7454021,2281732,The Light Between Oceans,Drama,-0.37270105
1353,2009-03-27,12 Rounds,20000000,12234694,17306648,2009,13,-7765306,-2693352,12 Rounds,Action,-0.3882653
1354,2010-10-01,Let Me In,20000000,12134935,28270399,2010,39,-7865065,8270399,Let Me In,Thriller/Suspense,-0.39325325
1355,2008-02-22,Be Kind Rewind,20000000,11175164,30894247,2008,8,-8824836,10894247,Be Kind Rewind,Comedy,-0.4412418
1356,2007-08-31,Death Sentence,20000000,9534258,16907831,2007,35,-10465742,-3092169,Death Sentence,Action,-0.5232871
1357,2016-06-03,Popstar: Never Stop Never Stopping,20000000,9496130,9537120,2016,22,-10503870,-10462880,Popstar: Never Stop Never Stopping,Comedy,-0.5251935
1358,2017-10-27,Thank You for Your Service,20000000,9479390,9985316,2017,43,-10520610,-10014684,Thank You for Your Service,Drama,-0.5260305
1359,2009-12-04,Everybody's Fine,20000000,9208876,9208876,2009,49,-10791124,-10791124,Everybody's Fine,Drama,-0.5395562
1360,2013-09-20,Battle of the Year,20000000,8888355,16723377,2013,38,-11111645,-3276623,Battle of the Year,Drama,-0.55558225
1361,2016-04-29,Ratchet and Clank,20000000,8813410,14365639,2016,17,-11186590,-5634361,Ratchet and Clank,Adventure,-0.5593295
1362,2007-01-05,Code Name: The Cleaner,20000000,8135024,8135024,2007,1,-11864976,-11864976,Code Name: The Cleaner,Comedy,-0.5932488
1363,2014-12-12,Inherent Vice,20000000,8110975,14772346,2014,50,-11889025,-5227654,Inherent Vice,Drama,-0.59445125
1364,2013-10-11,Machete Kills,20000000,8008161,18273009,2013,41,-11991839,-1726991,Machete Kills,Action,-0.59959195
1365,2006-02-24,Doogal,20000000,7578946,28058652,2006,8,-12421054,8058652,Doogal,Adventure,-0.6210527
1366,2008-10-03,An American Carol,20000000,7013191,7022183,2008,40,-12986809,-12977817,An American Carol,Comedy,-0.64934045
1367,2008-02-01,Strange Wilderness,20000000,6575282,6947084,2008,5,-13424718,-13052916,Strange Wilderness,Comedy,-0.6712359
1368,2015-04-24,Little Boy,20000000,6485961,17769299,2015,17,-13514039,-2230701,Little Boy,Drama,-0.67570195
1369,2012-10-26,Chasing Mavericks,20000000,6002756,8300821,2012,43,-13997244,-11699179,Chasing Mavericks,Drama,-0.6998622
1370,2014-12-31,A Most Violent Year,20000000,5749134,8846875,2014,1,-14250866,-11153125,A Most Violent Year,Drama,-0.7125433
1371,2011-11-23,A Dangerous Method,20000000,5702083,14807531,2011,47,-14297917,-5192469,A Dangerous Method,Drama,-0.71489585
1372,2006-07-07,A Scanner Darkly,20000000,5501616,7405084,2006,27,-14498384,-12594916,A Scanner Darkly,Thriller/Suspense,-0.7249192
1373,2009-08-14,Bandslam,20000000,5210988,12967829,2009,33,-14789012,-7032171,Bandslam,Comedy,-0.7394506
1374,2016-08-26,Hands of Stone,20000000,4712792,5031975,2016,34,-15287208,-14968025,Hands of Stone,Drama,-0.7643604
1375,2008-10-24,Passchendaele,20000000,4452423,4453327,2008,43,-15547577,-15546673,Passchendaele,Drama,-0.77737885
1376,2008-10-03,Flash of Genius,20000000,4442377,4504111,2008,40,-15557623,-15495889,Flash of Genius,Drama,-0.77788115
1377,2012-09-07,The Cold Light of Day,20000000,3763583,25361206,2012,36,-16236417,5361206,The Cold Light of Day,Thriller/Suspense,-0.81182085
1378,2009-05-15,The Brothers Bloom,20000000,3531756,5531756,2009,20,-16468244,-14468244,The Brothers Bloom,Black Comedy,-0.8234122
1379,2008-10-24,"Synecdoche, New York",20000000,3083538,4383538,2008,43,-16916462,-15616462,"Synecdoche, New York",Drama,-0.8458231
1380,2018-10-26,Suspiria,20000000,2483472,7023292,2018,43,-17516528,-12976708,Suspiria,Horror,-0.8758264
1381,2017-11-03,LBJ,20000000,2468683,2507181,2017,44,-17531317,-17492819,LBJ,Drama,-0.87656585
1382,2015-11-13,My All-American,20000000,2246000,2246000,2015,46,-17754000,-17754000,My All-American,Drama,-0.8877
1383,2006-05-05,The Proposition,20000000,1903434,5313608,2006,18,-18096566,-14686392,The Proposition,Drama,-0.9048283
1384,2011-04-29,Dylan Dog: Dead of Night,20000000,1186538,6093725,2011,17,-18813462,-13906275,Dylan Dog: Dead of Night,Horror,-0.9406731
1385,2012-08-29,The Oogieloves in the BIG Balloon Adventure,20000000,1065907,1065907,2012,35,-18934093,-18934093,The Oogieloves in the BIG Balloon Adventure,Adventure,-0.94670465
1386,2008-05-23,The Children of Huang Shi,20000000,1031872,8221700,2008,21,-18968128,-11778300,The Children of Huang Shi,Drama,-0.9484064
1387,2006-05-05,Mission: Impossible III,150000000,133501348,397501348,2006,18,-16498652,247501348,Mission: Impossible III,Action,-0.10999101333333333
